form	lemma	POS	morph
Principes	princeps1	NOMcom	Case=Voc|Numb=Plur
semper	semper	ADV	Deg=Pos
Africae	Africa	NOMpro	Case=Gen|Numb=Sing
viri	uir	NOMcom	Case=Voc|Numb=Plur
Carthaginienses	Carthaginienses	ADJqua	Case=Voc|Numb=Plur
vetustate	uetustas	NOMcom	Case=Abl|Numb=Sing
nobiles	nobilis2	ADJqua	Case=Acc|Numb=Plur|Gend=MascFem|Deg=Pos
novitate	nouitas	NOMcom	Case=Abl|Numb=Sing
felices	felix	ADJqua	Case=Acc|Numb=Plur|Gend=MascFem|Deg=Pos
gaudeo	gaudeo	VER	Numb=Sing|Mood=Ind|Tense=Pres|Voice=SemDep|Person=1
vos	uos	PROper	Case=Acc|Numb=Plur
tam	tam	ADV	Deg=Pos
prosperos	prosper	ADJqua	Case=Acc|Numb=Plur|Gend=Masc|Deg=Pos
temporum	tempus1	NOMcom	Case=Gen|Numb=Plur
cum	cum3	CONsub	MORPH=empty
ita	ita	ADV	Deg=Pos
vacat	uaco	VER	Numb=Sing|Mood=Ind|Tense=Pres|Voice=Act|Person=3
ac	ac1	CONcoo	MORPH=empty
iuvat	iuuo	VER	Numb=Sing|Mood=Ind|Tense=Pres|Voice=Act|Person=3
habitus	habitus1	NOMcom	Case=Acc|Numb=Plur
denotare	denoto	VER	Mood=Inf|Tense=Pres|Voice=Act
Pacis	pax	NOMcom	Case=Gen|Numb=Sing
haec	hic1	PROdem	Case=Nom|Numb=Plur|Gend=Neut
et	et2	CONcoo	MORPH=empty
annonae	annona	NOMcom	Case=Gen|Numb=Sing
otia	otium	NOMcom	Case=Acc|Numb=Plur
Ab	ab	PRE	MORPH=empty
imperio	imperium	NOMcom	Case=Abl|Numb=Sing
et	et2	CONcoo	MORPH=empty
a	ab	PRE	MORPH=empty
caelo	caelum1	NOMcom	Case=Abl|Numb=Sing
bene	bene	ADV	Deg=Pos
est	sum1	VER	Numb=Sing|Mood=Ind|Tense=Pres|Voice=Act|Person=3
Tamen	tamen	ADV	Deg=Pos
et	et2	CONcoo	MORPH=empty
vobis	uos	PROper	Case=Dat|Numb=Plur
habitus	habitus?	VER	Case=Nom|Numb=Sing|Mood=Par|Tense=Perf|Voice=Pass
aliter	aliter	ADV	Deg=Pos
olim	olim	ADV	Deg=Pos
tunicae	tunica	NOMcom	Case=Nom|Numb=Plur
fuere	sum1	VER	Numb=Plur|Mood=Ind|Tense=Perf|Voice=Act|Person=3
et	et2	CONcoo	MORPH=empty
quidem	quidem	ADV	Deg=Pos
in	in	PRE	MORPH=empty
fama	fama	NOMcom	Case=Abl|Numb=Sing
de	de	PRE	MORPH=empty
subteminis	subtemen	NOMcom	Case=Gen|Numb=Plur
studio	studium	NOMcom	Case=Abl|Numb=Sing
et	et2	CONcoo	MORPH=empty
luminis	lumen	NOMcom	Case=Gen|Numb=Sing
concilio	concilium	NOMcom	Case=Abl|Numb=Sing
et	et2	CONcoo	MORPH=empty
mensurae	mensura	NOMcom	Case=Gen|Numb=Sing
temperamento	temperamentum	NOMcom	Case=Abl|Numb=Sing
quod	quod1	PROrel	MORPH=empty
neque	neque	CONcoo	MORPH=empty
trans	trans2	PRE	MORPH=empty
crura	crus	NOMcom	Case=Acc|Numb=Plur
prodigae	prodigus	ADJqua	Case=Gen|Numb=Plur|Gend=Fem|Deg=Pos
nec	nec2	CONcoo	MORPH=empty
intra	intra2	PRE	MORPH=empty
genua	genu	NOMcom	Case=Acc|Numb=Plur
inverecundae	inuerecundus	ADJqua	Case=Nom|Numb=Plur|Gend=Fem|Deg=Pos
nec	nec2	CONcoo	MORPH=empty
brachiis	brachium	NOMcom	Case=Abl|Numb=Plur
parcae	parcus	ADJqua	Case=Nom|Numb=Plur
nec	nec2	CONcoo	MORPH=empty
manibus	manus1	NOMcom	Case=Abl|Numb=Plur
artae	artus2	ADJqua	Case=Nom|Numb=Plur|Gend=Fem|Deg=Pos
sed	sed	CONcoo	MORPH=empty
nec	nec2	CONcoo	MORPH=empty
cingulo	cingulum	NOMcom	Case=Dat|Numb=Sing
sinus	sinus	NOMcom	Case=Nom|Numb=Plur
dividere	diuido	VER	Mood=Inf|Tense=Pres|Voice=Act|Person=3
expedito	expeditus	ADJqua	Case=Abl|Numb=Sing|Gend=MascNeut
umbratae	umbro	VER	Case=Nom|Numb=Plur|Gend=Fem|Mood=Par|Tense=Perf|Voice=Pass
quadrata	quadratus2	ADJqua	Case=Abl|Numb=Sing|Gend=Fem|Deg=Pos
iustitia	iustitia	NOMcom	Case=Nom|Numb=Sing
in	in	PRE	MORPH=empty
viris	uis	NOMcom	Case=Abl|Numb=Plur
stabant	sto	VER	Numb=Plur|Mood=Ind|Tense=Impa|Voice=Act|Person=3
Pallii	Pallius	NOMpro	Case=Gen|Numb=Sing
extrinsecus	extrinsecus	ADV	Deg=Pos
habitus	habitus?	VER	Case=Nom|Numb=Plur
et	et2	CONcoo	MORPH=empty
ipse	ipse	PROdem	Case=Nom|Numb=Sing|Gend=Masc
quadrangulus	quadrangulus	NOMcom	Case=Nom|Numb=Sing|Deg=Pos
ab	ab	PRE	MORPH=empty
utroque	uterque	PROind	Case=Abl|Numb=Sing|Gend=MascNeut
laterum	latus1	NOMcom	Case=Gen|Numb=Plur
regestus	regero	NOMcom	Case=Nom|Numb=Sing|Gend=Masc|Mood=Par|Tense=Perf|Voice=Pass
et	et2	CONcoo	MORPH=empty
cervicibus	ceruix	NOMcom	Case=Abl|Numb=Plur
circumstrictus	circumstrictus	VER	Case=Nom|Numb=Sing|Gend=Masc|Mood=Par|Tense=Perf|Voice=Pass
in	in	PRE	MORPH=empty
fibulae	fibula	NOMcom	Case=Gen|Numb=Sing
morsu	morsus	NOMcom	Case=Abl|Numb=Sing
humeris	humerus	NOMcom	Case=Dat|Numb=Plur
acquiescebat	acquiesco	VER	Numb=Sing|Mood=Ind|Tense=Impa|Voice=Act|Person=3
Instar	instar	NOMcom	Case=Ind
eius	is	PROdem	Case=Gen|Numb=Sing|Gend=Com
hodie	hodie	ADV	Deg=Pos
Aesculapio	Aesculapius	NOMpro	Case=Dat|Numb=Sing
iam	iam	ADV	Deg=Pos
vestro	uester	PROpos	Case=Dat|Numb=Sing|Gend=MascNeut
sacerdotium	sacerdotium	NOMcom	Case=Nom|Numb=Sing
est	sum1	VER	Numb=Sing|Mood=Ind|Tense=Pres|Voice=Act|Person=3
Sic	sic	ADV	Deg=Pos
et	et2	CONcoo	Deg=Pos
in	in	PRE	MORPH=empty
proximo	propior	NOMcom	Case=Abl|Numb=Sing
soror	soror	NOMcom	Case=Nom|Numb=Sing
civitas	ciuitas	NOMcom	Case=Nom|Numb=Sing
vestiebat	uestio	VER	Numb=Sing|Mood=Ind|Tense=Impa|Voice=Act|Person=3
et	et2	CONcoo	MORPH=empty
sicubi	sicubi	CONsub	MORPH=empty
alibi	alibi	ADV	Deg=Pos
in	in	PRE	MORPH=empty
Africa	Africa	NOMpro	Case=Abl|Numb=Sing
Tyros	Tyrus	NOMpro	Case=Nom|Numb=Sing
At	at2	CONcoo	MORPH=empty
cum	cum3	CONsub	MORPH=empty
saecularium	saecularis	ADJqua	Case=Gen|Numb=Plur
sortium	sors	NOMcom	Case=Gen|Numb=Plur
variavit	uario	VER	Numb=Sing|Mood=Ind|Tense=Perf|Voice=Act|Person=3
urna	urna	NOMcom	Case=Nom|Numb=Sing
et	et2	CONcoo	MORPH=empty
Romanis	Romani	NOMpro	Case=Dat|Numb=Plur
deus	deus	NOMcom	Case=Nom|Numb=Sing
maluit	malo	VER	Numb=Sing|Mood=Ind|Tense=Perf|Voice=Act|Person=3
soror	soror	NOMcom	Case=Nom|Numb=Sing
quidem	quidem	ADV	Deg=Pos
civitas	ciuitas	NOMcom	Case=Nom|Numb=Sing
suopte	suus	PROpos.ref	Case=Abl|Numb=Sing|Gend=MascNeut
arbitrio	arbitrium	NOMcom	Case=Abl|Numb=Sing
mutare	muto2	VER	Mood=Inf|Tense=Pres|Voice=Act
properavit	propero	VER	Numb=Sing|Mood=Ind|Tense=Perf|Voice=Act|Person=3
ut	ut4	CONsub	MORPH=empty
adpulsum	appello2	VER	Case=Acc|Numb=Sing|Gend=MascNeut|Mood=Par|Tense=Perf|Voice=Pass
Scipionem	Scipio	NOMpro	Case=Acc|Numb=Sing
ante	ante1	ADV	Deg=Pos
iam	iam	ADV	Deg=Pos
de	de	PRE	MORPH=empty
habitu	habitus1	NOMcom	Case=Abl|Numb=Sing
salutasset	saluto	VER	Numb=Sing|Mood=Sub|Tense=Pqp|Voice=Act|Person=3
Romanum	Romanus	ADJqua	Case=Acc|Numb=Sing|Gend=MascNeut|Deg=Pos
praecoca	praecox	VER	Case=Nom|Numb=Sing|Deg=Pos
Vobis	uos	PROper	Case=Dat|Numb=Plur
vero	uero4	CONcoo	MORPH=empty
post	post2	PRE	MORPH=empty
iniuriae	iniuria	NOMcom	Case=Gen|Numb=Sing
beneficium	beneficium	NOMcom	Case=Acc|Numb=Sing
ut	ut4	CONsub	MORPH=empty
senium	senium	NOMcom	Case=Acc|Numb=Sing
non	non	ADVneg	MORPH=empty
fastigium	fastigium	NOMcom	Case=Nom|Numb=Sing
exemptis	eximo	VER	Case=Abl|Numb=Plur|Gend=Com|Mood=Par|Tense=Perf|Voice=Pass
post	post1	ADV	MORPH=empty
Gracchi	Gracchus	NOMpro	Case=Gen|Numb=Sing
obscena	obscenus	ADJqua	Case=Acc|Numb=Plur|Gend=Neut|Deg=Pos
omina	omen	NOMcom	Case=Acc|Numb=Plur
et	et2	CONcoo	MORPH=empty
Lepidi	Lepidus	NOMpro	Case=Gen|Numb=Sing
violenta	uiolentus	ADJqua	Case=Acc|Numb=Plur|Gend=Neut|Deg=Pos
ludibria	ludibrium	NOMcom	Case=Acc|Numb=Plur
post	post2	PRE	MORPH=empty
trinas	trinus	ADJdis	Case=Acc|Numb=Plur|Gend=Fem
Pompei	Pompeius	NOMpro	Case=Gen|Numb=Sing
aras	ara	NOMcom	Case=Acc|Numb=Plur
et	et2	CONcoo	MORPH=empty
longas	longus	ADJqua	Case=Acc|Numb=Plur|Gend=Fem|Deg=Pos
Caesaris	Caesar	NOMpro	Case=Gen|Numb=Sing
moras	mora	NOMcom	Case=Acc|Numb=Plur
ubi	ubi1	ADVrel	MORPH=empty
moenia	moenia	NOMcom	Case=Acc|Numb=Plur
Statilius	Statilius	NOMpro	Case=Nom|Numb=Sing
Taurus	Taurus	NOMpro	Case=Nom|Numb=Sing
imposuit	impono	VER	Numb=Sing|Mood=Ind|Tense=Perf|Voice=Act|Person=3
sollemnia	sollemne	NOMcom	Case=Acc|Numb=Plur
Sentius	Sentius	NOMpro	Case=Nom|Numb=Sing
Saturninus	Saturninus	NOMpro	Case=Nom|Numb=Sing
enarravit	enarro	VER	Numb=Sing|Mood=Ind|Tense=Perf|Voice=Act|Person=3
cum	cum3	CONsub	MORPH=empty
concordia	concordia	NOMcom	Case=Abl|Numb=Sing
iuvat	iuuo	VER	Numb=Sing|Mood=Ind|Tense=Pres|Voice=Act|Person=3
toga	toga	NOMcom	Case=Nom|Numb=Sing
oblata	offero	VER	Case=Nom|Numb=Sing|Gend=Fem|Mood=Par|Tense=Perf|Voice=Pass
est	sum1	VER	Numb=Sing|Mood=Ind|Tense=Pres|Voice=Act|Person=3
Pro	pro1	PRE	MORPH=empty
quantum	quantum1	PROrel	Case=Acc|Numb=Sing|Gend=MascNeut
circummeavit	circummeo	VER	Numb=Sing|Mood=Ind|Tense=Perf|Voice=Act|Person=3
a	ab	PRE	MORPH=empty
Pelasgis	Pelasgi	NOMpro	Case=Abl|Numb=Plur
ad	ad2	PRE	MORPH=empty
Lydos	Lydi	NOMpro	Case=Acc|Numb=Plur
a	ab	PRE	MORPH=empty
Lydis	Lydi	NOMpro	Case=Abl|Numb=Plur|Deg=Pos
ad	ad2	PRE	MORPH=empty
Romanos	Romani	NOMpro	Case=Acc|Numb=Plur
ut	ut4	CONsub	MORPH=empty
ab	ab	PRE	MORPH=empty
humeris	humerus	NOMcom	Case=Abl|Numb=Plur
sublimioris	sublimus1	ADJqua	Case=Gen|Numb=Sing|Gend=Com|Deg=Comp
populi	populus1	NOMcom	Case=Gen|Numb=Sing
Carthaginienses	Carthaginienses	ADJqua	Case=Nom|Numb=Plur
complecteretur	complector	VER	Numb=Sing|Mood=Sub|Tense=Impa|Voice=Dep|Person=3
Exinde	exinde	ADV	Deg=Pos
tunicam	tunica	NOMcom	Case=Acc|Numb=Sing
longiorem	longus	ADJqua	Case=Acc|Numb=Sing|Gend=MascFem|Deg=Comp
cinctu	cingo	VER	Case=Abl|Numb=Sing
arbitrante	arbitror	VER	Case=Abl|Numb=Sing|Gend=Com|Mood=Par|Tense=Pres|Voice=Dep
suspenditis	suspendo	VER	Numb=Plur|Mood=Ind|Tense=Pres|Voice=Act
et	et2	CONcoo	MORPH=empty
pallii	pallium	NOMcom	Case=Gen|Numb=Sing
iam	iam	ADV	Deg=Pos
teretis	teres	ADJqua	Case=Gen|Numb=Plur|Gend=Com|Deg=Pos
redundantiam	redundantia	NOMcom	Case=Acc|Numb=Sing
tabulata	tabulatum	NOMcom	Case=Abl|Numb=Sing
congregatione	congregatio	NOMcom	Case=Abl|Numb=Sing
fulcitis	fulcio	VER	Numb=Plur|Gend=Com|Mood=Ind|Tense=Pres|Voice=Act
et	et2	CONcoo	MORPH=empty
si	si2	CONsub	MORPH=empty
quid	quis2	PROind	Case=Acc|Numb=Sing|Gend=Neut
praeterea	praeterea	ADV	Deg=Pos
condicio	condicio	NOMcom	Case=Nom|Numb=Sing
vel	uel2	CONcoo	MORPH=empty
dignitas	dignitas	NOMcom	Case=Nom|Numb=Sing
vel	uel2	CONcoo	MORPH=empty
temporalitas	temporalitas	NOMcom	Case=Nom|Numb=Sing
vestit	uestio	VER	Numb=Sing|Mood=Ind|Tense=Pres|Voice=Act|Person=3
pallium	pallium	NOMcom	Case=Acc|Numb=Sing
tamen	tamen	ADV	Deg=Pos
generaliter	generaliter	ADV	Deg=Pos
vestrum	uester	PROper	Case=Acc|Numb=Sing
immemores	immemor	ADJqua	Case=Nom|Numb=Sing|Gend=MascFem|Deg=Pos
etiam	etiam	ADV	Deg=Pos
denotatis	denoto	VER	Case=Abl|Numb=Sing|Mood=Par|Tense=Perf|Voice=Pass
Equidem	equidem	ADV	Deg=Pos
haud	haud	ADVneg	MORPH=empty
miror	miror	VER	Numb=Sing|Mood=Ind|Tense=Pres|Voice=Dep|Person=1
prae	prae2	PRE	MORPH=empty
documento	documentum	NOMcom	Case=Abl|Numb=Sing
superiore	superus	ADJqua	Case=Abl|Numb=Sing|Gend=Com|Deg=Comp
Nam	nam	CONcoo	MORPH=empty
et	et2	CONcoo	MORPH=empty
arietem	aries	NOMcom	Case=Acc|Numb=Sing
non	non	ADVneg	MORPH=empty
quem	qui1	PROrel	Case=Acc|Numb=Sing|Gend=Masc
Laberius	Laberius	NOMpro	Numb=Sing
reciprocicornem	reciprocicor	NOMcom	Case=Acc|Numb=Sing
et	et2	CONcoo	MORPH=empty
lanicutem	lanicute	NOMcom	Case=Acc|Numb=Sing|Gend=MascFem
et	et2	CONcoo	MORPH=empty
testitrahum	testitrahus	NOMcom	Case=Acc|Numb=Sing
sed	sed	CONcoo	MORPH=empty
trabes	trabs	NOMcom	Case=Acc|Numb=Plur
machina	machina	NOMcom	Case=Nom|Numb=Sing
est	sum1	VER	Numb=Sing|Mood=Ind|Tense=Pres|Voice=Act|Person=3
quae	qui1	PROrel	Case=Nom|Numb=Sing|Gend=Fem
muros	murus	NOMcom	Case=Acc|Numb=Plur
frangere	frango	VER	Mood=Inf|Tense=Pres|Voice=Act
militat	milito2	VER	Numb=Sing|Mood=Ind|Tense=Pres|Voice=Act|Person=3
nemini	nemo	PROind	Case=Dat|Numb=Sing
unquam	umquam	ADV	Deg=Pos
adhuc	adhuc	ADV	Deg=Pos
libratum	libro	VER	Numb=Sing|Gend=MascNeut|Mood=Par|Tense=Perf|Voice=Pass
illa	ille	PROdem	Case=Nom|Numb=Sing|Gend=Fem
dicitur	dico2	VER	Numb=Sing|Mood=Ind|Tense=Pres|Voice=Pass|Person=3
Carthago	Carthago	NOMpro	Case=Nom|Numb=Sing
studiis	studium	NOMcom	Case=Dat|Numb=Plur
asperrima	asper	ADJqua	Case=Nom|Numb=Sing|Gend=Fem|Deg=Sup
belli	bellum	NOMcom	Case=Gen|Numb=Sing
prima	primus	ADJord	Case=Nom|Numb=Sing|Gend=Fem|Deg=Sup
omnium	omnis	PROind	Case=Gen|Numb=Plur|Gend=Com
armasse	armo	VER	Mood=Inf|Tense=Perf|Voice=Act
in	in	PRE	MORPH=empty
oscillum	oscillum1	NOMcom	Case=Acc|Numb=Sing
penduli	pendulus	ADJqua	Case=Gen|Numb=Sing|Gend=MascNeut|Deg=Pos
impetus	impetus	NOMcom	Case=Gen|Numb=Sing
commentata	commentor2	VER	Case=Nom|Numb=Sing|Gend=Fem|Mood=Par|Tense=Perf|Voice=Dep
vim	uis	NOMcom	Case=Acc|Numb=Sing
tormenti	tormentum	NOMcom	Case=Gen|Numb=Sing
de	de	PRE	MORPH=empty
bile	bilis	NOMcom	Case=Abl|Numb=Sing
pecoris	pecus1	NOMcom	Case=Gen|Numb=Sing
caput	caput	NOMcom	Case=Acc|Numb=Sing
vindicantis	uindico	VER	Case=Gen|Numb=Sing|Gend=Com|Mood=Par|Tense=Pres|Voice=Act
Cum	cum3	CONsub	MORPH=empty
tamen	tamen	ADV	Deg=Pos
ultimant	ultimo2	VER	Numb=Plur|Mood=Ind|Tense=Pres|Voice=Act|Person=3
tempora	tempus1	NOMcom	Case=Nom|Numb=Plur
patriae	patria	NOMcom	Case=Gen|Numb=Sing
et	et2	CONcoo	MORPH=empty
aries	aries	NOMcom	Case=Nom|Numb=Sing
iam	iam	ADV	Deg=Pos
Romanus	Romanus	ADJqua	Case=Nom|Numb=Sing|Gend=Masc|Deg=Pos
in	in	PRE	MORPH=empty
muros	murus	NOMcom	Case=Acc|Numb=Plur
quodam	quidam	PROind	Case=Abl|Numb=Sing|Gend=MascNeut
suos	sui2	PROpos.ref	Case=Acc|Numb=Plur|Gend=Masc
audet	audeo	VER	Numb=Sing|Mood=Ind|Tense=Pres|Voice=SemDep|Person=3
stupuere	stupeo	VER	Numb=Plur|Mood=Ind|Tense=Perf|Voice=Act|Person=3
illico	illico	ADV	Deg=Pos
Carthaginienses	Carthaginienses	NOMpro	Case=Acc|Numb=Plur
ut	ut1	ADVrel	MORPH=empty
novum	nouus	ADJqua	Case=Nom|Numb=Sing|Gend=Neut|Deg=Pos
extraneum	extraneus	ADJqua	Case=Nom|Numb=Sing|Gend=Neut|Deg=Pos
ingenium	ingenium	NOMcom	Case=Nom|Numb=Sing
Tantum	tantum1	PROdem	Case=Acc|Numb=Sing|Gend=MascNeut
aevi	aeuum	NOMcom	Case=Gen|Numb=Sing
longinqua	longinquus	ADJqua	Case=Nom|Numb=Sing|Gend=Fem|Deg=Pos
valet	ualeo	VER	Numb=Sing|Mood=Ind|Tense=Pres|Voice=Act|Person=3
mutare	muto2	VER	Mood=Inf|Tense=Pres|Voice=Act
vetustas	uetustas	NOMcom	Case=Nom|Numb=Sing
Sic	sic	ADV	Deg=Pos
denique	denique	ADV	Deg=Pos
nec	nec2	CONcoo	MORPH=empty
pallium	pallium	NOMcom	Case=Nom|Numb=Sing
agnoscitur	agnosco	VER	Numb=Sing|Mood=Ind|Tense=Pres|Voice=Pass|Person=3
Sit	sum1	VER	Numb=Sing|Mood=Sub|Tense=Pres|Voice=Act|Person=3
nunc	nunc	ADV	Deg=Pos
aliunde	aliunde	ADV	Deg=Pos
res	res	NOMcom	Case=Nom|Numb=Sing
ne	ne4	CONsub	MORPH=empty
Poenicum	Poenicus	ADJqua	Case=Nom|Numb=Sing|Deg=Pos
inter	inter	PRE	MORPH=empty
Romanos	Romani	NOMpro	Case=Acc|Numb=Plur
aut	aut	CONcoo	MORPH=empty
erubescat	erubesco	VER	Numb=Sing|Mood=Sub|Tense=Pres|Voice=Act|Person=3
aut	aut	CONcoo	MORPH=empty
doleat	doleo	VER	Numb=Sing|Mood=Sub|Tense=Pres|Voice=Act|Person=3
Certe	certe	ADV	Deg=Pos
habitum	habitus1	NOMcom	Case=Acc|Numb=Sing
vertere	uerto	VER	Mood=Inf|Tense=Pres|Voice=Act
naturae	natura	NOMcom	Case=Gen|Numb=Sing
totius	totus	PROind	Case=Gen|Numb=Sing|Gend=Com
sollemne	sollemnis	ADJqua	Case=Nom|Numb=Sing|Gend=Neut|Deg=Pos
munus	munus	NOMcom	Case=Nom|Numb=Sing
est	sum1	VER	Numb=Sing|Mood=Ind|Tense=Pres|Voice=Act|Person=3
Fungitur	fungor	VER	Numb=Sing|Mood=Ind|Tense=Pres|Voice=Dep|Person=3
et	et2	CONcoo	MORPH=empty
ipse	ipse	PROdem	Case=Nom|Numb=Sing|Gend=Masc
mundus	mundus1	NOMcom	Case=Nom|Numb=Sing
interim	interim	ADV	Deg=Pos
iste	iste	PROdem	Case=Nom|Numb=Sing|Gend=Masc
quem	qui1	PROrel	Case=Acc|Numb=Sing|Gend=Masc
incumbimus	incumbo	VER	Numb=Plur|Mood=Ind|Tense=Pres|Voice=Act|Person=1
Viderit	uideo	VER	Numb=Sing|Mood=Sub|Tense=Perf|Voice=Act|Person=3
Anaximander	Anaximander	NOMpro	Case=Nom|Numb=Sing
si	si2	CONsub	MORPH=empty
plures	multus	ADJqua	Case=Acc|Numb=Plur|Gend=MascFem|Deg=Comp
putat	puto	VER	Numb=Sing|Mood=Ind|Tense=Pres|Voice=Act|Person=3
viderit	uideo	VER	Numb=Sing|Mood=Ind|Tense=FutAnt|Voice=Act|Person=3
si	si2	CONsub	MORPH=empty
quis	quis2	PROind	Case=Nom|Numb=Sing|Gend=MascFem
uspiam	uspiam	ADV	Deg=Pos
alius	alius	PROind	Case=Nom|Numb=Sing|Gend=Masc
ad	ad2	PRE	MORPH=empty
Meropas	Meropa	NOMpro	Case=Acc|Numb=Plur|Gend=Fem
ut	ut1	ADVrel	MORPH=empty
Silenus	Silenus	NOMpro	Case=Nom|Numb=Sing
penes	penes	PRE	MORPH=empty
aures	auris	NOMcom	Case=Acc|Numb=Plur
Midae	Midas	NOMpro	Case=Gen|Numb=Sing
blatit	blatio	VER	Numb=Sing|Mood=Ind|Tense=Pres|Voice=Act|Person=3
aptas	aptus	ADJqua	Case=Acc|Numb=Plur|Gend=Fem|Deg=Pos
sane	sane	ADV	Deg=Pos
grandioribus	grandis	ADJqua	Case=Abl|Numb=Plur|Gend=Com|Deg=Comp
fabulis	fabula1	NOMcom	Case=Abl|Numb=Plur
Sed	sed	CONcoo	MORPH=empty
et	et2	CONcoo	MORPH=empty
si	si2	CONsub	MORPH=empty
quem	quis2	PROind	Case=Acc|Numb=Sing|Gend=Masc
Plato	Platon	NOMpro	Case=Nom|Numb=Sing
aestimat	aestimo	VER	Numb=Sing|Mood=Ind|Tense=Pres|Voice=Act|Person=3
cuius	qui1	PROrel	Case=Gen|Numb=Sing|Gend=Com
imago	imago	NOMcom	Case=Nom|Numb=Sing
hic	hic1	PROdem	Case=Nom|Numb=Sing|Gend=Masc
sit	sum1	VER	Numb=Sing|Mood=Sub|Tense=Pres|Voice=Act|Person=3
etiam	etiam	ADV	Deg=Pos
ille	ille	PROdem	Case=Nom|Numb=Sing|Gend=Masc
habeat	habeo	VER	Numb=Sing|Mood=Sub|Tense=Pres|Voice=Act|Person=3
necesse	necesse	ADJqua	Case=Ind|Deg=Pos
est	sum1	VER	Numb=Sing|Mood=Ind|Tense=Pres|Voice=Act|Person=3
proinde	proinde	ADV	Deg=Pos
mutare	muto2	VER	Mood=Inf|Tense=Pres|Voice=Act
Quippe	quippe2	CONcoo	MORPH=empty
si	si2	CONsub	MORPH=empty
mundus	mundus1	NOMcom	Case=Nom|Numb=Sing
ex	ex	PRE	MORPH=empty
diversis	diuersus	ADJqua	Case=Abl|Numb=Plur|Gend=Com|Deg=Pos
substantiis	substantia	NOMcom	Case=Abl|Numb=Plur
officiisque	officium	NOMcom	Case=Abl|Numb=Plur
{officiisque}	que	CON	MORPH=empty
constabit	consto	VER	Numb=Sing|Mood=Ind|Tense=Fut|Voice=Act|Person=3
ad	ad2	PRE	MORPH=empty
formam	forma	NOMcom	Case=Acc|Numb=Sing
eius	is	PROdem	Case=Gen|Numb=Sing|Gend=Com
quod	qui1	PROrel	Numb=Sing
mundus	mundus1	NOMcom	Case=Nom|Numb=Sing|Deg=Pos
hic	hic1	PROdem	Case=Nom|Numb=Sing|Gend=Masc
est	sum1	VER	Numb=Sing|Mood=Ind|Tense=Pres|Voice=Act|Person=3
neque	neque	CONcoo	MORPH=empty
enim	enim2	CONcoo	MORPH=empty
mundus	mundus1	NOMcom	Case=Nom|Numb=Sing
si	si2	CONsub	MORPH=empty
non	non	ADVneg	MORPH=empty
ut	ut1	ADVrel	MORPH=empty
mundus	mundus1	NOMcom	Case=Nom|Numb=Sing
proinde	proinde	ADV	Deg=Pos
Diversa	diuersus	ADJqua	Case=Nom|Numb=Plur|Gend=Neut|Deg=Pos
in	in	PRE	MORPH=empty
unum	unum	NOMcom	Case=Acc|Numb=Sing
ex	ex	PRE	MORPH=empty
demutatione	demutatio	NOMcom	Case=Abl|Numb=Sing
diversa	diuersus	ADJqua	Case=Nom|Numb=Plur|Gend=Neut|Deg=Pos
sunt	sum1	VER	Numb=Plur|Mood=Ind|Tense=Pres|Voice=Act|Person=3
Denique	denique	ADV	Deg=Pos
diversitatis	diuersitas	NOMcom	Case=Gen|Numb=Sing
discordiam	discordia	NOMcom	Case=Acc|Numb=Sing
vices	uicis	NOMcom	Case=Nom|Numb=Plur
foederant	foedeo	VER	Numb=Plur|Mood=Ind|Tense=Pres|Voice=Act|Person=3
Ita	ita	ADV	Deg=Pos
mutando	muto2	VER	Case=Abl|Numb=Sing|Mood=Ger|Voice=Act
erit	sum1	VER	Numb=Sing|Mood=Ind|Tense=Fut|Voice=Act|Person=3
mundus	mundus1	NOMcom	Case=Nom|Numb=Sing
omnis	omnis	PROind	Case=Nom|Numb=Sing|Gend=MascFem
qui	qui1	PROrel	Case=Nom|Numb=Sing|Gend=Masc
ex	ex	PRE	MORPH=empty
diversitatibus	diuersitas	NOMcom	Case=Abl|Numb=Plur
corporatus	corporo	NOMcom	Case=Nom|Numb=Sing|Gend=Masc
et	et2	CONcoo	MORPH=empty
vicibus	uicis	NOMcom	Case=Abl|Numb=Plur
temperatus	temperatus2	ADJqua	Case=Nom|Numb=Sing|Gend=Masc
Nostra	noster	PROpos	Case=Nom|Numb=Sing|Gend=Fem
certe	certe	ADV	Deg=Pos
metatio	metatio	NOMcom	Case=Nom|Numb=Sing
quod	quod1	PROrel	Case=Nom|Gend=Neut
clausis	claudo1	VER	Case=Abl|Numb=Plur|Gend=Com|Mood=Par|Tense=Perf|Voice=Pass
vel	uel2	CONcoo	MORPH=empty
in	in	PRE	MORPH=empty
totum	totum	NOMcom	Case=Acc|Numb=Sing
Homericis	Homericus	ADJqua	Case=Abl|Numb=Plur|Gend=Com|Deg=Pos
oculis	oculus	NOMcom	Case=Abl|Numb=Plur
liquet	liqueo	VER	Numb=Sing|Mood=Ind|Tense=Pres|Voice=Act|Person=3
totum	totus	PROind	Case=Nom|Numb=Sing|Gend=Neut
versiforme	uersiformis	ADJqua	Case=Nom|Numb=Sing|Deg=Pos
est	sum1	VER	Numb=Sing|Mood=Ind|Tense=Pres|Voice=Act|Person=3
Dies	dies	NOMcom	Case=Nom|Numb=Sing
et	et2	CONcoo	MORPH=empty
nox	nox	NOMcom	Case=Nom|Numb=Sing
invicem	inuicem	ADV	Deg=Pos
vertunt	uerto	VER	Numb=Plur|Mood=Ind|Tense=Pres|Voice=Act|Person=3
Sol	sol	NOMcom	Case=Nom|Numb=Sing
stationibus	statio	NOMcom	Case=Abl|Numb=Plur
annuis	annuus	ADJqua	Case=Abl|Numb=Plur|Gend=Com|Deg=Pos
luna	luna	NOMcom	Case=Nom|Numb=Sing
modulationibus	modulatio	NOMcom	Case=Abl|Numb=Plur
menstruis	menstruus	NOMcom	Case=Abl|Numb=Plur|Gend=Com|Deg=Pos
variat	uario	VER	Numb=Sing|Mood=Ind|Tense=Pres|Voice=Act|Person=3
Siderum	sidus	NOMcom	Case=Acc|Numb=Plur
distincta	distinctus2	ADJqua	Case=Nom|Numb=Sing|Gend=Fem
confusio	confusio	NOMcom	Case=Nom|Numb=Sing
interdum	interdum	ADV	Deg=Pos
deicit	deicio	VER	Numb=Sing|Mood=Ind|Tense=Pres|Voice=Act|Person=3
quid	quis1	PROint	Case=Acc|Numb=Sing|Gend=Neut
interdum	interdum	ADV	Deg=Pos
resuscitat	resuscito	VER	Numb=Sing|Mood=Ind|Tense=Pres|Voice=Act|Person=3
Caeli	caelum1	NOMcom	Case=Gen|Numb=Sing
ambitus	ambitus	NOMcom	Case=Nom|Numb=Sing
nunc	nunc	ADV	Deg=Pos
subdivo	subdiuo	NOMcom	Case=Abl|Numb=Sing|Gend=MascNeut
splendidus	splendidus	ADJqua	Case=Nom|Numb=Sing|Gend=Masc|Deg=Pos
nunc	nunc	ADV	Deg=Pos
nubilo	nubilum	NOMcom	Case=Abl|Numb=Sing
sordidus	sordidus	ADJqua	Case=Nom|Numb=Sing|Gend=Masc|Deg=Pos
aut	aut	CONcoo	MORPH=empty
imbres	imber	NOMcom	Case=Nom|Numb=Plur
ruunt	ruo	VER	Numb=Plur|Mood=Ind|Tense=Pres|Voice=Act|Person=3
et	et2	CONcoo	MORPH=empty
si	si2	CONsub	MORPH=empty
qua	qua2	PROind	Case=Nom|Numb=Plur|Gend=Neut
missilia	missilis	NOMcom	Case=Nom|Numb=Plur|Deg=Pos
cum	cum2	PRE	MORPH=empty
imbribus	imber	NOMcom	Case=Abl|Numb=Plur
dehinc	dehinc	ADV	Deg=Pos
substillum	substillus	NOMcom	Case=Nom|Numb=Sing|Gend=Neut
et	et2	CONcoo	MORPH=empty
denuo	denuo2	ADV	Deg=Pos
sudum	sudus	ADJqua	Case=Nom|Numb=Sing|Deg=Pos
Sic	sic	ADV	Deg=Pos
et	et2	CONcoo	MORPH=empty
mari	mare	NOMcom	Case=Abl|Numb=Sing
fides	fides2	NOMcom	Case=Nom|Numb=Sing
infamis	infamis	ADJqua	Case=Nom|Numb=Sing|Gend=MascFem|Deg=Pos
dum	dum2	CONsub	MORPH=empty
et	et2	CONcoo	MORPH=empty
flabris	flabrum	NOMcom	Case=Abl|Numb=Plur
aeque	aeque	ADV	Deg=Pos
mutantibus	muto2	VER	Case=Abl|Numb=Plur|Gend=Com|Mood=Par|Tense=Pres|Voice=Act
de	de	PRE	MORPH=empty
tranquillo	tranquillum	NOMcom	Case=Abl|Numb=Sing
probum	probus	ADJqua	Case=Nom|Numb=Sing|Gend=Neut|Deg=Pos
de	de	PRE	MORPH=empty
flustris	flustrum	NOMcom	Case=Abl|Numb=Plur
temperatum	tempero	VER	Numb=Sing|Gend=Neut|Deg=Pos|Mood=Par|Tense=Perf|Voice=Pass
et	et2	CONcoo	MORPH=empty
extemplo	extemplo	ADV	Deg=Pos
de	de	PRE	MORPH=empty
decumanis	decimanus1	NOMcom	Case=Abl|Numb=Plur
inquietat	inquieto	VER	Numb=Sing|Mood=Ind|Tense=Pres|Voice=Act|Person=3
Sic	sic	ADV	Deg=Pos
et	et2	CONcoo	MORPH=empty
terram	terra	NOMcom	Case=Acc|Numb=Sing
si	si2	CONsub	MORPH=empty
recenseas	recenseo	VER	Numb=Sing|Mood=Sub|Tense=Pres|Voice=Act|Person=2
temporatim	temporatim	ADV	Deg=Pos
vestiri	uestio	VER	Mood=Inf|Tense=Pres|Voice=Pass
amantem	amans1	NOMcom	Case=Acc|Numb=Sing|Gend=MascFem
prope	prope1	ADV	Deg=Pos
sis	si	CONsub	Mood=Sub|Tense=Pres|Voice=Act|Person=2
{sis}	uolo		MORPH=empty
eandem	idem	PROdem	Case=Acc|Numb=Sing|Gend=Fem
negare	nego	VER	Mood=Inf|Tense=Pres|Voice=Act
memor	memor	ADJqua	Case=Nom|Numb=Sing|Gend=Com|Deg=Pos
viridem	uiridis	ADJqua	Case=Acc|Numb=Sing|Gend=MascFem|Deg=Pos
cum	cum3	CONsub	MORPH=empty
conspicis	conspicio	VER	Numb=Sing|Mood=Ind|Tense=Pres|Voice=Act|Person=2
flavam	flauus	ADJqua	Case=Acc|Numb=Sing|Gend=Fem|Deg=Pos
mox	mox	ADV	Deg=Pos
visurus	uideo	VER	Case=Nom|Numb=Sing|Gend=Masc|Mood=Par|Tense=Fut|Voice=Act
et	et2	CONcoo	MORPH=empty
canam	cano	VER	Numb=Sing|Mood=Ind|Tense=Fut|Voice=Act
Ceteri	ceterus	NOMcom	Case=Gen|Numb=Plur
quoque	quoque	ADV	Deg=Pos
eius	is	PROdem	Case=Gen|Numb=Sing|Gend=Com
ornatus	ornatus1	NOMcom	Case=Acc|Numb=Plur
quid	quis1	PROint	Case=Acc|Numb=Sing|Gend=Neut
non	non	ADVneg	MORPH=empty
aliud	alius	PROind	Case=Acc|Numb=Sing|Gend=Neut
ex	ex	PRE	MORPH=empty
alio	alius	PROind	Case=Abl|Numb=Sing|Gend=MascNeut
mutant	muto2	VER	Numb=Plur|Mood=Ind|Tense=Pres|Voice=Act|Person=3
et	et2	CONcoo	MORPH=empty
montium	mons	NOMcom	Case=Gen|Numb=Plur
scapulae	scapula	NOMcom	Case=Nom|Numb=Plur
decurrendo	decurro	VER	Case=Abl|Numb=Sing|Mood=Ger|Voice=Act
et	et2	CONcoo	MORPH=empty
fontium	fons	NOMcom	Case=Gen|Numb=Plur
venae	uena	NOMcom	Case=Gen|Numb=Plur
cavillando	cauillo	VER	Case=Abl|Numb=Sing|Mood=Ger|Voice=Dep
et	et2	CONcoo	MORPH=empty
fluminum	flumen	NOMcom	Case=Gen|Numb=Plur
viae	uia	NOMcom	Case=Gen|Numb=Sing
obhumando	obhumo	VER	Case=Abl|Numb=Sing|Mood=Ger|Voice=Act
Mutavit	muto2	VER	Numb=Sing|Mood=Ind|Tense=Perf|Voice=Act|Person=3
et	et2	CONcoo	MORPH=empty
totus	totus	PROind	Case=Nom|Numb=Sing|Gend=Masc
orbis	orbis	NOMcom	Case=Nom|Numb=Sing
aliquando	aliquando	ADV	Deg=Pos
aquis	aqua	NOMcom	Case=Abl|Numb=Plur
omnibus	omnis	PROind	Case=Abl|Numb=Plur|Gend=Com
obsitus	obsero3	VER	Case=Nom|Numb=Sing|Gend=Masc|Mood=Par|Tense=Perf|Voice=Pass
Adhuc	adhuc	ADV	Deg=Pos
maris	mare	NOMcom	Case=Gen|Numb=Sing
conchae	concha	NOMcom	Case=Gen|Numb=Sing
et	et2	CONcoo	MORPH=empty
buccinae	buccina	NOMcom	Case=Gen|Numb=Plur
peregrinantur	peregrinor	VER	Numb=Plur|Mood=Ind|Tense=Pres|Voice=Dep|Person=3
in	in	PRE	MORPH=empty
montibus	mons	NOMcom	Case=Abl|Numb=Plur
cupientes	cupio	VER	Case=Nom|Numb=Plur|Gend=MascFem|Mood=Par|Tense=Pres|Voice=Act
Platoni	Platon	NOMpro	Case=Dat|Numb=Sing
probare	probo	VER	Mood=Inf|Tense=Pres|Voice=Act
etiam	etiam	ADV	Deg=Pos
ardua	arduus	NOMcom	Case=Acc|Numb=Plur|Gend=Neut|Deg=Pos
fluitasse	fluito	VER	Mood=Inf|Tense=Perf|Voice=Act
Sed	sed	CONcoo	MORPH=empty
et	et2	CONcoo	Deg=Pos
enatando	enato	VER	Case=Abl|Numb=Sing|Mood=Ger|Voice=Dep
rursus	rursus	ADV	Deg=Pos
in	in	PRE	MORPH=empty
forma	forma	NOMcom	Case=Abl|Numb=Sing
mutavit	muto2	VER	Numb=Sing|Mood=Ind|Tense=Perf|Voice=Act|Person=3
rursus	rursus	ADV	Deg=Pos
orbis	orbis	NOMcom	Case=Nom|Numb=Sing
alius	alius	PROind	Case=Nom|Numb=Sing|Gend=Masc
idem	idem	PROdem	Case=Acc|Numb=Sing|Gend=MascNeut
Mutat	muto2	VER	Numb=Sing|Mood=Ind|Tense=Pres|Voice=Act|Person=3
et	et2	CONcoo	MORPH=empty
nunc	nunc	ADV	Deg=Pos
localiter	localiter	ADV	Deg=Pos
habitus	habitus1	NOMcom	Case=Nom|Numb=Sing|Gend=Masc|Mood=Par|Tense=Perf|Voice=Pass
cum	cum3	CONsub	MORPH=empty
situs	situs1	NOMcom	Case=Nom|Numb=Sing
laeditur	laedo	VER	Numb=Sing|Mood=Ind|Tense=Pres|Voice=Pass|Person=3
cum	cum3	CONsub	MORPH=empty
inter	inter	PRE	MORPH=empty
insulas	insula	NOMcom	Case=Acc|Numb=Plur
nulla	nullus	PROind	Case=Nom|Numb=Sing|Gend=Fem
iam	iam	ADV	Deg=Pos
Delos	Delos	NOMpro	Case=Nom|Numb=Sing
harenae	arena	NOMcom	Case=Gen|Numb=Sing
Samos	Samus	NOMpro	Case=Nom|Numb=Sing
et	et2	CONcoo	MORPH=empty
Sibylla	Sibylla	NOMpro	Case=Nom|Numb=Sing
non	non	ADVneg	MORPH=empty
mendax	mendax	ADJqua	Case=Nom|Numb=Sing|Gend=Com|Deg=Pos
cum	cum3	CONsub	MORPH=empty
in	in	PRE	MORPH=empty
Atlantico	Atlanticus	NOMpro	Case=Abl|Numb=Sing
Libyam	Libya	NOMpro	Case=Acc|Numb=Sing
aut	aut	CONcoo	MORPH=empty
Asiam	Asia	NOMpro	Case=Acc|Numb=Sing
adaequans	adaequo	VER	Case=Nom|Numb=Sing|Gend=Com|Mood=Par|Tense=Pres|Voice=Act
quaeritur	quaero	VER	Numb=Sing|Mood=Ind|Tense=Pres|Voice=Pass|Person=3
cum	cum3	CONsub	MORPH=empty
Italiae	Italia	NOMpro	Case=Gen|Numb=Sing
quondam	quondam	ADV	Deg=Pos
latus	latus1	NOMcom	Case=Nom|Numb=Sing
Hadria	Hadria	NOMpro	Case=Abl|Numb=Sing
Tyrrhenoque	Tyrrhenus	ADJqua	Case=Abl|Numb=Sing|Deg=Pos
{Tyrrhenoque}	que	CON	MORPH=empty
quassantibus	quasso	VER	Case=Dat|Numb=Plur|Gend=Com|Mood=Par|Tense=Pres|Voice=Act
mediotenus	mediotenus	ADV	Case=Nom|Deg=Pos
interceptum	intercipio	VER	Case=Acc|Numb=Sing|Gend=MascNeut|Mood=Par|Tense=Perf|Voice=Pass
reliquias	reliquiae	NOMcom	Case=Acc|Numb=Plur
Siciliam	Sicilia	NOMpro	Case=Acc|Numb=Sing
facit	facio	VER	Numb=Sing|Mood=Ind|Tense=Pres|Voice=Act|Person=3
cum	cum3	CONsub	MORPH=empty
tota	totus	PROind	Case=Abl|Numb=Sing|Gend=Fem
illa	ille	PROdem	Case=Nom|Numb=Sing|Gend=Fem
plaga	plaga1	NOMcom	Case=Abl|Numb=Sing
discidii	discidium	NOMcom	Case=Gen|Numb=Sing
contentiosos	contentiosus	ADJqua	Case=Acc|Numb=Plur|Gend=Masc|Deg=Pos
aequorum	aequus	NOMcom	Case=Gen|Numb=Plur
coitus	coitus	NOMcom	Case=Acc|Numb=Plur
angustis	angustus	ADJqua	Case=Abl|Numb=Plur|Gend=Com|Deg=Pos
retorquens	retorqueo	VER	Case=Nom|Numb=Sing|Gend=Com|Mood=Par|Tense=Pres|Voice=Act
novum	nouus	ADJqua	Case=Acc|Numb=Sing|Gend=MascNeut|Deg=Pos
vitii	uitium	NOMcom	Case=Gen|Numb=Sing
mari	mare	NOMcom	Case=Abl|Numb=Sing
induit	induo	VER	Numb=Sing|Mood=Ind|Tense=Pres|Voice=Act|Person=3
non	non	ADVneg	MORPH=empty
exspuentis	exspuo	VER	Case=Gen|Numb=Sing|Gend=Com|Mood=Par|Tense=Pres|Voice=Act
naufragia	naufragium	NOMcom	Case=Acc|Numb=Plur
sed	sed	CONcoo	MORPH=empty
devorantis	deuoro	VER	Case=Gen|Numb=Sing|Gend=MascFem|Mood=Par|Tense=Pres|Voice=Act
Patitur	patior	VER	Numb=Sing|Mood=Ind|Tense=Pres|Voice=Dep|Person=3
et	et2	CONcoo	MORPH=empty
continens	continens3	ADJqua	Case=Nom|Numb=Sing|Gend=Com|Deg=Pos|Mood=Par|Tense=Pres|Voice=Act
de	de	PRE	MORPH=empty
caelo	caelum1	NOMcom	Case=Abl|Numb=Sing
aut	aut	CONcoo	MORPH=empty
de	de	PRE	MORPH=empty
suo	suum	NOMcom	Case=Abl|Numb=Sing|Gend=MascNeut
Aspice	aspicio	VER	Numb=Sing
ad	ad2	PRE	MORPH=empty
Palaestinam	Palaestinus	ADJqua	Case=Acc|Numb=Sing|Gend=Fem|Deg=Pos
Qua	qua1	ADVrel	Gend=Fem
Iordanis	Iordanes	NOMpro	Case=Nom|Numb=Sing
amnis	amnis	NOMcom	Case=Nom|Numb=Sing
finium	finis	NOMcom	Case=Gen|Numb=Plur
arbiter	arbiter	NOMcom	Case=Nom|Numb=Sing
vastitas	uastitas	NOMcom	Case=Nom|Numb=Sing
ingens	ingens	ADJqua	Case=Nom|Numb=Sing|Gend=Com|Deg=Pos
et	et2	CONcoo	MORPH=empty
orba	orbus	ADJqua	Case=Nom|Numb=Sing|Gend=Fem|Deg=Pos
regio	regio	NOMcom	Case=Nom|Numb=Sing
et	et2	CONcoo	MORPH=empty
frustra	frustra	ADV	Deg=Pos
ager	ager	NOMcom	Case=Nom|Numb=Sing
Et	et2	CONcoo	MORPH=empty
urbes	urbs	NOMcom	Case=Nom|Numb=Plur
retro	retro1	ADV	Deg=Pos
et	et2	CONcoo	MORPH=empty
populi	populus1	NOMcom	Case=Gen|Numb=Plur
frequentes	frequens	ADJqua	Case=Nom|Numb=Plur|Gend=MascFem|Deg=Pos
et	et2	CONcoo	MORPH=empty
solus	solus	PROind	Case=Nom|Numb=Sing|Gend=Masc
audiebat	audio	VER	Numb=Sing|Mood=Ind|Tense=Impa|Voice=Act|Person=3
Dehinc	dehinc	ADV	Deg=Pos
ut	ut1	ADVrel	MORPH=empty
deus	deus	NOMcom	Case=Nom|Numb=Sing
censor	censor	NOMcom	Case=Nom|Numb=Sing
est	sum1	VER	Numb=Sing|Mood=Ind|Tense=Pres|Voice=Act|Person=3
impietas	impietas	NOMcom	Case=Nom|Numb=Sing
ignium	ignis	NOMcom	Case=Gen|Numb=Plur
meruit	mereo	VER	Numb=Sing|Mood=Ind|Tense=Perf|Voice=Act|Person=3
imbres	imber	NOMcom	Case=Acc|Numb=Plur
hactenus	hactenus	ADV	Deg=Pos
Sodoma	Sodoma	NOMpro	Case=Nom|Numb=Sing
et	et2	CONcoo	MORPH=empty
nulla	nullus	PROind	Case=Nom|Numb=Sing|Gend=Fem
Gomorrha	Gomorrha	NOMpro	Case=Nom|Numb=Sing
et	et2	CONcoo	MORPH=empty
cinis	cinis	NOMcom	Case=Nom|Numb=Sing
omnia	omnis	PROind	Case=Nom|Numb=Plur|Gend=Neut
et	et2	CONcoo	MORPH=empty
propinquitas	propinquitas	NOMcom	Case=Nom|Numb=Sing
maris	mare	NOMcom	Case=Gen|Numb=Sing
iuxta	iuxta1	ADV	Deg=Pos
cum	cum2	PRE	MORPH=empty
solo	solum1	NOMcom	Case=Abl|Numb=Sing
mortem	mors	NOMcom	Case=Acc|Numb=Sing
vivit	uiuo	VER	Numb=Sing|Mood=Ind|Tense=Pres|Voice=Act|Person=3
Ex	ex	PRE	MORPH=empty
huiuscemodi	huiusmodi	ADV	Deg=Pos
nubilo	nubilum	NOMcom	Case=Abl|Numb=Sing
et	et2	CONcoo	MORPH=empty
Tuscia	Tuscia	NOMpro	Case=Abl|Numb=Sing
Vulsinios	Uolsinii	NOMpro	Case=Acc|Numb=Plur
pristinos	pristinus	ADJqua	Case=Acc|Numb=Plur|Gend=Masc|Deg=Pos
deusta	deuro	VER	Case=Nom|Numb=Sing|Gend=Fem|Mood=Par|Tense=Perf|Voice=Pass
quo	quo5	CONsub	MORPH=empty
magis	magis2	ADV	Deg=Comp
de	de	PRE	MORPH=empty
montibus	mons	NOMcom	Case=Abl|Numb=Plur
suis	suus	PROpos.ref	Case=Abl|Numb=Plur|Gend=Com
Campania	Campania	NOMpro	Case=Nom|Numb=Sing
speret	spero	VER	Numb=Sing|Mood=Sub|Tense=Pres|Voice=Act|Person=3
erepta	eripio	VER	Case=Nom|Numb=Sing|Gend=Fem|Mood=Par|Tense=Perf|Voice=Pass
Pompeios	Pompei	NOMpro	Case=Acc|Numb=Plur
Sed	sed	CONcoo	MORPH=empty
absit	absum1	VER	Numb=Sing|Mood=Sub|Tense=Pres|Voice=Act|Person=3
Utinam	utinam	ADV	Deg=Pos
et	et2	CONcoo	MORPH=empty
Asia	Asia	NOMpro	Case=Nom|Numb=Sing
secura	securus	ADJqua	Case=Nom|Numb=Sing|Gend=Fem|Deg=Pos
iam	iam	ADV	Deg=Pos
sit	sum1	VER	Numb=Sing|Mood=Sub|Tense=Pres|Voice=Act|Person=3
de	de	PRE	MORPH=empty
soli	solum1	NOMcom	Case=Gen|Numb=Sing|Gend=Com
ingluvie	ingluuies	NOMcom	Case=Abl|Numb=Sing
Utinam	utinam	ADV	Deg=Pos
et	et2	CONcoo	MORPH=empty
Africa	Africa	NOMpro	Case=Nom|Numb=Sing
semel	semel	ADJadv.mul	MORPH=empty
voraginem	uorago	NOMcom	Case=Acc|Numb=Sing
paverit	pasco	VER	Numb=Sing|Mood=Sub|Tense=Perf|Voice=Act|Person=3
unicis	unicus	ADJqua	Case=Abl|Numb=Plur|Gend=Com|Deg=Pos
castris	castra2	NOMcom	Case=Abl|Numb=Plur
fraudatis	fraudo	VER	Case=Abl|Numb=Plur|Gend=Com|Mood=Par|Tense=Perf|Voice=Pass
expiata	expio	VER	Case=Nom|Numb=Plur|Gend=Neut|Mood=Par|Tense=Perf|Voice=Pass
Multa	multus	ADJqua	Case=Nom|Numb=Plur|Gend=Neut|Deg=Pos
et	et2	CONcoo	MORPH=empty
alia	alius	PROind	Case=Acc|Numb=Plur|Gend=Neut
huiusmodi	huiusmodi	ADV	Deg=Pos
detrimenta	detrimentum	NOMcom	Case=Nom|Numb=Plur
habitum	habeo	VER	Case=Nom|Numb=Sing
orbis	orbis	NOMcom	Case=Gen|Numb=Sing
novavere	nouo	VER	Numb=Plur|Person=3
situsque	situs	NOMcom	Case=Acc|Numb=Plur
{situsque}	que	CON	MORPH=empty
movere	moueo	VER	Mood=Inf|Tense=Pres|Voice=Act
Bellis	bellum	NOMcom	Case=Dat|Numb=Plur
quoque	quoque	ADVrel	Deg=Pos
plurimum	multum2	ADV	Deg=Sup
licuit	licet1	VER	Numb=Sing|Mood=Ind|Tense=Perf|Voice=Act|Person=3
Sed	sed	CONcoo	MORPH=empty
piget	piget	VER	Numb=Sing|Mood=Ind|Tense=Pres|Voice=Act|Person=3
tristia	tristis	ADJqua	Case=Acc|Numb=Plur|Gend=Neut|Deg=Pos
non	non	ADVneg	MORPH=empty
minus	parum2	ADV	Deg=Comp
quam	quam1	ADVrel	MORPH=empty
regnorum	regnum	NOMcom	Case=Gen|Numb=Plur
vices	uicis	NOMcom	Case=Nom|Numb=Plur
recensere	recenseo	VER	Mood=Inf|Tense=Pres|Voice=Act
quotiens	quotiens1	ADVrel	MORPH=empty
et	et2	CONcoo	Deg=Pos
ista	iste	PROdem	Case=Acc|Numb=Plur|Gend=Neut
mutaverint	muto2	VER	Numb=Plur|Mood=Sub|Tense=Perf|Voice=Act|Person=3
iam	iam	ADV	Deg=Pos
inde	inde	ADV	Deg=Pos
a	ab	PRE	MORPH=empty
Nino	Nino	NOMcom	Case=Abl|Numb=Sing|Deg=Pos
Beli	Belus	NOMpro	Case=Voc|Numb=Sing
progenie	progenies	NOMcom	Case=Voc|Numb=Sing
si	si2	CONsub	MORPH=empty
tamen	tamen	ADV	Deg=Pos
Ninus	Ninus	NOMcom	Case=Nom|Numb=Sing
regnare	regno	VER	Mood=Inf|Tense=Pres|Voice=Act
primus	primus	ADJord	Case=Nom|Numb=Sing|Gend=Masc|Deg=Sup
ut	ut1	ADVrel	MORPH=empty
autumat	autumo	VER	Numb=Sing|Mood=Ind|Tense=Pres|Voice=Act|Person=3
superiorum	superus	ADJqua	Case=Gen|Numb=Plur|Deg=Comp
profanitas	profanitas	NOMcom	Case=Nom|Numb=Sing
Ferme	ferme	ADV	Deg=Pos
apud	apud	PRE	MORPH=empty
vos	uos	PROper	Case=Acc|Numb=Plur
ultra	ultra1	ADV	Deg=Pos
stilus	stilus	NOMcom	Case=Nom|Numb=Sing
non	non	ADVneg	MORPH=empty
solet	soleo	VER	Numb=Sing|Mood=Ind|Tense=Pres|Voice=SemDep|Person=3
Ab	ab	PRE	MORPH=empty
Assyriis	Assyrii	NOMpro	Case=Abl|Numb=Plur
si	si2	CONsub	MORPH=empty
forte	forte	ADV	Deg=Pos
aevi	aeuum	NOMcom	Case=Gen|Numb=Sing
historiae	historia	NOMcom	Case=Nom|Numb=Sing
patescunt	patesco	VER	Numb=Plur|Mood=Ind|Tense=Pres|Voice=Act|Person=3
Qui	qui1	PROrel	Case=Nom|Numb=Plur|Gend=Masc
vero	uero4	CONcoo	MORPH=empty
divinas	diuinus2	ADJqua	Case=Acc|Numb=Plur|Gend=Fem|Deg=Pos
lectitamus	lectito	VER	Numb=Plur|Mood=Ind|Tense=Pres|Voice=Act
ab	ab	PRE	MORPH=empty
ipsius	ipse	PROdem	Case=Gen|Numb=Sing|Gend=Com
mundi	mundus1	NOMcom	Case=Gen|Numb=Sing
natalibus	natales	NOMcom	Case=Abl|Numb=Plur
competes	competo	ADJqua	Case=Nom|Numb=Plur|Deg=Pos
sumus	sum1	VER	Numb=Plur|Mood=Ind|Tense=Pres|Voice=Act|Person=1
Sed	sed	CONcoo	MORPH=empty
laeta	laetus2	ADJqua	Case=Nom|Numb=Plur|Gend=Neut|Deg=Pos
iam	iam	ADV	Deg=Pos
malo	malum1	NOMcom	Case=Abl|Numb=Sing
quippe	quippe2	CONcoo	MORPH=empty
et	et2	CONcoo	MORPH=empty
laeta	laetus2	ADJqua	Case=Acc|Numb=Plur|Gend=Neut|Deg=Pos
mutant	muto2	VER	Numb=Plur|Mood=Ind|Tense=Pres|Voice=Act|Person=3
Denique	denique	ADV	Deg=Pos
si	si2	CONsub	MORPH=empty
quid	quis2	PROind	Case=Acc|Numb=Sing|Gend=Neut
mare	mare	NOMcom	Case=Acc|Numb=Sing
diluit	diluo	VER	Numb=Sing|Mood=Ind|Tense=Perf|Voice=Act|Person=3
caelum	caelum1	NOMcom	Case=Acc|Numb=Sing
deussit	deuro	VER	Numb=Sing|Mood=Ind|Tense=Perf|Voice=Act|Person=3
terra	terra	NOMcom	Case=Nom|Numb=Sing
subduxit	subduco	VER	Numb=Sing|Mood=Ind|Tense=Perf|Voice=Act|Person=3
gladius	gladius	NOMcom	Case=Nom|Numb=Sing
detotondit	detotondeo	VER	Numb=Sing|Mood=Ind|Tense=Perf|Voice=Act|Person=3
alias	alius	PROind	Case=Acc|Numb=Plur|Gend=Fem|Deg=Pos
versura	uersura	NOMcom	Case=Nom|Numb=Sing
compensati	compenso	VER	Case=Gen|Numb=Sing|Mood=Par|Tense=Perf|Voice=Pass
redit	redeo1	VER	Numb=Sing|Mood=Ind|Tense=Perf|Voice=Act|Person=3
Nam	nam	CONcoo	MORPH=empty
et	et2	CONcoo	MORPH=empty
primitus	primitus	ADV	Deg=Pos
maiorem	magnus	ADJqua	Case=Acc|Numb=Sing|Gend=MascFem|Deg=Comp
ambitum	ambitus	NOMcom	Case=Acc|Numb=Sing
terra	terra	NOMcom	Case=Nom|Numb=Sing
cassa	cassus	ADJqua	Case=Nom|Numb=Sing|Gend=Fem|Deg=Pos
et	et2	CONcoo	MORPH=empty
vacans	uaco	VER	Case=Nom|Numb=Sing|Gend=Com|Mood=Par|Tense=Pres|Voice=Act
hominum	homo	NOMcom	Case=Gen|Numb=Plur
et	et2	CONcoo	MORPH=empty
sicubi	sicubi	CONsub	MORPH=empty
aliqua	aliquis	PROind	Case=Nom|Numb=Sing|Gend=Fem
gens	gens	NOMcom	Case=Nom|Numb=Sing
occuparat	occupo2	VER	Numb=Sing|Mood=Ind|Tense=Pqp|Voice=Act|Person=3
sibimet	sui1	PROref	Case=Dat|Numb=Sing
soli	solus	PROind	Case=Dat|Numb=Sing|Gend=Com
erat	sum1	VER	Numb=Sing|Mood=Ind|Tense=Impa|Voice=Act|Person=3
Itaque	itaque	CONcoo	MORPH=empty
colere	colo2	VER	Mood=Inf|Tense=Pres|Voice=Act
omnia	omnis	PROind	Case=Acc|Numb=Plur|Gend=Neut
se	sui1	PROref	Case=Acc|Numb=Sing
demum	demum	ADV	Deg=Pos
intellegens	intelligo	VER	Case=Nom|Numb=Sing|Gend=Com|Mood=Par|Tense=Pres|Voice=Act
alibi	alibi	ADV	Deg=Pos
stipantem	stipo	VER	Case=Acc|Numb=Sing|Gend=MascFem|Mood=Par|Tense=Pres|Voice=Act
copiam	copia	NOMcom	Case=Acc|Numb=Sing
alibi	alibi	ADV	Deg=Pos
deserentem	desero2	VER	Case=Acc|Numb=Sing|Gend=MascFem|Mood=Par|Tense=Pres|Voice=Act
runcare	runco	VER	Mood=Inf|Tense=Pres|Voice=Act
atque	atque1	CONcoo	MORPH=empty
ruspare	ruspo	VER	Mood=Inf|Tense=Pres|Voice=Act
consuluit	consulo	VER	Numb=Sing|Mood=Ind|Tense=Perf|Voice=Act|Person=3
ut	ut4	CONsub	MORPH=empty
inde	inde	ADV	Deg=Pos
velut	uelut1	ADVrel	MORPH=empty
ex	ex	PRE	MORPH=empty
surculis	surculus	NOMcom	Case=Abl|Numb=Plur
et	et2	CONcoo	MORPH=empty
propaginibus	propago1	NOMcom	Case=Abl|Numb=Plur
populi	populus1	NOMcom	Case=Nom|Numb=Sing
de	de	PRE	MORPH=empty
populis	populus1	NOMcom	Case=Abl|Numb=Plur
urbes	urbs	NOMcom	Case=Nom|Numb=Plur
de	de	PRE	MORPH=empty
urbibus	urbs	NOMcom	Case=Abl|Numb=Plur
per	per	PRE	MORPH=empty
ubique	ubique	ADV	Deg=Pos
orbis	orbis	NOMcom	Case=Acc|Numb=Plur
pangerentur	pango	VER	Numb=Plur|Mood=Sub|Tense=Impa|Voice=Pass|Person=3
Transvolavere	transuolo2	VER	Numb=Plur|Mood=Ind|Tense=Perf|Voice=Act|Person=3
redundantium	redundo	VER	Case=Gen|Numb=Plur|Gend=Com|Mood=Par|Tense=Pres|Voice=Act
gentium	gens	NOMcom	Case=Gen|Numb=Plur
examina	examen	NOMcom	Case=Acc|Numb=Plur
Scythae	Scythae	NOMpro	Case=Nom|Numb=Plur
exuberant	exubero	VER	Numb=Plur|Mood=Ind|Tense=Pres|Voice=Act|Person=3
Persas	Persae	NOMpro	Case=Acc|Numb=Plur
Phoenices	Phoenices	NOMpro	Case=Nom|Numb=Plur
in	in	PRE	MORPH=empty
Africam	Africa	NOMpro	Case=Acc|Numb=Sing
eructant	eructo	VER	Numb=Plur|Mood=Ind|Tense=Pres|Voice=Act|Person=3
Romanos	Romani	NOMpro	Case=Acc|Numb=Plur|Gend=Masc
Phryges	Phryges	NOMpro	Case=Acc|Numb=Plur
pariunt	pario2	VER	Numb=Plur|Mood=Ind|Tense=Pres|Voice=Act|Person=3
Chaldaeum	Chaldaei	NOMpro	Case=Nom|Numb=Sing
semen	semen1	NOMcom	Case=Nom|Numb=Sing
in	in	PRE	MORPH=empty
Aegyptum	Aegyptus	NOMpro	Case=Acc|Numb=Sing
educatur	educo1	VER	Numb=Sing|Mood=Ind|Tense=Pres|Voice=Pass|Person=3
dehinc	dehinc	ADV	Deg=Pos
cum	cum3	CONsub	MORPH=empty
inde	inde	ADV	Deg=Pos
transducitur	traduco	VER	Numb=Sing|Mood=Ind|Tense=Pres|Voice=Pass|Person=3
Iudaea	Iudaea	NOMpro	Case=Nom|Numb=Sing
gens	gens	NOMcom	Case=Nom|Numb=Sing
est	sum1	VER	Numb=Sing|Mood=Ind|Tense=Pres|Voice=Act|Person=3
Sic	sic	ADV	Deg=Pos
et	et2	CONcoo	Deg=Pos
Herculea	Herculeus	ADJqua	Case=Nom|Numb=Sing|Gend=Fem|Deg=Pos
posteritas	posteritas	NOMcom	Case=Nom|Numb=Sing
Temeno	Temenus	NOMpro	Case=Abl|Numb=Sing
pariter	pariter	ADV	Deg=Pos
Peloponnesum	Peloponnesus	NOMpro	Case=Acc|Numb=Sing
occupando	occupo2	VER	Case=Abl|Numb=Sing|Mood=Ger|Voice=Act
producunt	produco	VER	Numb=Plur|Mood=Ind|Tense=Pres|Voice=Act|Person=3
Sic	sic	ADV	Deg=Pos
et	et2	CONcoo	Deg=Pos
Iones	Iones	NOMpro	Case=Nom|Numb=Plur
Nelei	Nelius	NOMpro	Case=Gen|Numb=Plur
comites	comes	NOMcom	Case=Nom|Numb=Plur
Asiam	Asia	NOMpro	Case=Acc|Numb=Sing
novis	nouus	ADJqua	Case=Abl|Numb=Plur|Gend=Com|Deg=Pos
urbibus	urbs	NOMcom	Case=Abl|Numb=Plur
instruunt	instruo	VER	Numb=Plur|Mood=Ind|Tense=Pres|Voice=Act|Person=3
sic	sic	ADV	Deg=Pos
et	et2	CONcoo	Deg=Pos
Corinthii	Corinthii	NOMpro	Case=Nom|Numb=Plur|Gend=Masc
cum	cum2	PRE	MORPH=empty
Archia	Archias	NOMpro	Case=Abl|Numb=Sing
muniunt	munio2	VER	Numb=Plur|Mood=Ind|Tense=Pres|Voice=Act|Person=3
Syracusas	Syracusae	NOMpro	Case=Acc|Numb=Plur
Sed	sed	CONcoo	MORPH=empty
vanum	uanus	ADJqua	Case=Acc|Numb=Sing|Gend=MascNeut|Deg=Pos
iam	iam	ADV	Deg=Pos
antiquitas	antiquitas	NOMcom	Case=Nom|Numb=Sing
quando	quando3	CONsub	MORPH=empty
curricula	curriculum	NOMcom	Case=Acc|Numb=Plur
nostra	noster	PROpos	Case=Nom|Numb=Plur|Gend=Neut
coram	coram2	PRE	MORPH=empty
Quantum	quantum1	PROrel	Case=Acc|Numb=Sing|Gend=MascNeut
reformavit	reformo	VER	Numb=Sing|Mood=Ind|Tense=Perf|Voice=Act|Person=3
orbis	orbis	NOMcom	Case=Nom|Numb=Sing
saeculum	saeculum	NOMcom	Case=Nom|Numb=Sing
istud	iste	PROdem	Case=Acc|Numb=Sing|Gend=Neut
quantum	quantum3	ADVrel	Case=Acc|Numb=Sing|Gend=MascNeut
urbium	urbs	NOMcom	Case=Gen|Numb=Plur
aut	aut	CONcoo	MORPH=empty
produxit	produco	VER	Numb=Sing|Mood=Ind|Tense=Perf|Voice=Act|Person=3
aut	aut	CONcoo	MORPH=empty
auxit	augeo	VER	Numb=Sing|Mood=Ind|Tense=Perf|Voice=Act|Person=3
aut	aut	CONcoo	MORPH=empty
reddidit	reddo	VER	Numb=Sing|Mood=Ind|Tense=Perf|Voice=Act|Person=3
praesentis	praesens	ADJqua	Case=Gen|Numb=Sing|Gend=Com|Deg=Pos
imperii	imperium	NOMcom	Case=Gen|Numb=Sing
triplex	triplex	ADJmul	Case=Nom|Numb=Sing|Gend=Com|Deg=Pos
virtus	uirtus	NOMcom	Case=Nom|Numb=Sing
Deo	deus	NOMcom	Case=Dat|Numb=Sing
tot	tot	PROdem	Case=Ind
Augustis	Augustus	NOMpro	Case=Dat|Numb=Plur
in	in	PRE	MORPH=empty
unum	unum	ADJcar	Case=Acc|Numb=Sing
favente	faueo	VER	Case=Abl|Numb=Sing|Gend=Com|Mood=Par|Tense=Pres|Voice=Act
quot	quot1	PROrel	Case=Ind
census	census	NOMcom	Case=Nom|Numb=Plur
transcripti	transcribo	VER	Case=Nom|Numb=Plur|Gend=Masc|Mood=Par|Tense=Perf|Voice=Pass
quot	quot1	PROrel	Case=Ind
populi	populus1	NOMcom	Case=Nom|Numb=Plur
repugnati	repugno	VER	Case=Nom|Numb=Plur|Gend=Masc|Mood=Par|Tense=Perf|Voice=Pass
quot	quot1	PROrel	Case=Ind
ordines	ordo	NOMcom	Case=Nom|Numb=Plur
illustrati	illustro2	VER	Case=Nom|Numb=Plur|Gend=Masc|Mood=Par|Tense=Perf|Voice=Pass
quot	quot1	PROrel	Case=Ind
barbari	barbarus1	NOMcom	Case=Nom|Numb=Plur
exclusi	excludo	VER	Case=Nom|Numb=Plur|Gend=MascNeut|Mood=Par|Tense=Perf|Voice=Pass
Revera	reuera	ADV	Deg=Pos
orbis	orbis	NOMcom	Case=Gen|Numb=Sing
cultissimum	cultus2	ADJqua	Case=Nom|Numb=Sing|Gend=Neut|Deg=Sup
huius	hic1	PROdem	Case=Gen|Numb=Sing|Gend=Com
imperii	imperium	NOMcom	Case=Gen|Numb=Sing
rus	rus	NOMcom	Case=Nom|Numb=Sing
est	sum1	VER	Numb=Sing|Mood=Ind|Tense=Pres|Voice=Act|Person=3
eradicato	eradico	VER	Case=Abl|Numb=Sing|Gend=MascNeut|Mood=Par|Tense=Perf|Voice=Pass
omni	omnis	PROind	Case=Abl|Numb=Sing|Gend=Com
aconito	aconitum	VER	Case=Abl|Numb=Sing
hostilitatis	hostilitas	NOMcom	Case=Gen|Numb=Sing
et	et2	CONcoo	MORPH=empty
cacto	cango	VER	Case=Abl|Numb=Sing|Gend=MascNeut|Mood=Par|Tense=Perf|Voice=Pass
et	et2	CONcoo	MORPH=empty
rubo	rubus	NOMcom	Case=Abl|Numb=Sing
subdolae	subdolus	NOMcom	Case=Gen|Numb=Sing|Gend=Fem|Deg=Pos
familiaritatis	familiaritas	NOMcom	Case=Gen|Numb=Sing
convulso	conuello	VER	Case=Abl|Numb=Sing|Gend=MascNeut|Mood=Par|Tense=Perf|Voice=Pass
et	et2	CONcoo	MORPH=empty
amoenus	amoenus	ADJqua	Case=Nom|Numb=Sing|Gend=Masc|Deg=Pos
super	super2	PRE	MORPH=empty
Alcinoi	Alcinous	NOMpro	Case=Gen|Numb=Sing
pometum	pometum	NOMcom	Case=Acc|Numb=Sing
et	et2	CONcoo	MORPH=empty
Midae	Midas	NOMpro	Case=Gen|Numb=Sing
rosetum	rosetus	ADJqua	Case=Acc|Numb=Sing
Laudans	laudo	VER	Case=Nom|Numb=Sing|Gend=Com|Mood=Par|Tense=Pres|Voice=Act
igitur	igitur	CONcoo	MORPH=empty
orbem	orbis	NOMcom	Case=Acc|Numb=Sing
mutantem	muto2	VER	Case=Acc|Numb=Sing|Gend=MascFem|Mood=Par|Tense=Pres|Voice=Act
quid	quis1	PROint	Case=Acc|Numb=Sing|Gend=Neut
denotas	denoto	VER	Case=Acc|Numb=Plur|Gend=Fem|Mood=Par|Tense=Perf|Voice=Pass
hominem	homo	NOMcom	Case=Acc|Numb=Sing
Mutant	muto2	VER	Numb=Plur|Mood=Ind|Tense=Pres|Voice=Act|Person=3
et	et2	CONcoo	MORPH=empty
bestiae	bestia	NOMcom	Case=Nom|Numb=Plur
pro	pro1	PRE	MORPH=empty
veste	uestis	NOMcom	Case=Abl|Numb=Sing
formam	forma	NOMcom	Case=Acc|Numb=Sing
quamquam	quamquam2	CONsub	MORPH=empty
et	et2	CONcoo	MORPH=empty
pavo	pauus	NOMcom	Case=Dat|Numb=Sing|Deg=Pos
pluma	pluma	NOMcom	Case=Abl|Numb=Sing
vestis	uestis	NOMcom	Case=Nom|Numb=Sing
et	et2	CONcoo	MORPH=empty
quidem	quidem	ADV	Deg=Pos
de	de	PRE	MORPH=empty
cataclistis	cataclita	NOMcom	Case=Abl|Numb=Plur
immo	immo	ADV	Deg=Pos
omni	omnis	PROind	Case=Abl|Numb=Sing|Gend=Com
conchylio	conchylium	NOMcom	Case=Abl|Numb=Sing
pressior	pressus2	ADJqua	Case=Nom|Numb=Sing|Gend=MascFem|Deg=Comp
qua	qua1	ADVrel	MORPH=empty
colla	collum	NOMcom	Case=Nom|Numb=Plur
florent	floreo	VER	Numb=Plur|Mood=Ind|Tense=Pres|Voice=Act|Person=3
et	et2	CONcoo	MORPH=empty
omni	omnis	PROind	Case=Abl|Numb=Sing|Gend=Com
patagio	patagium	NOMcom	Case=Abl|Numb=Sing
inauratior	inauratus	ADJqua	Case=Nom|Numb=Sing|Gend=MascFem|Deg=Comp
qua	qua1	ADVrel	MORPH=empty
terga	tergum	NOMcom	Case=Nom|Numb=Plur
fulgent	fulgeo	VER	Numb=Plur|Mood=Ind|Tense=Pres|Voice=Act|Person=3
et	et2	CONcoo	MORPH=empty
omni	omnis	PROind	Case=Abl|Numb=Sing|Gend=Com
syrmate	syrma	NOMcom	Case=Abl|Numb=Sing
solutior	solutus	ADJqua	Case=Nom|Numb=Sing|Gend=MascFem|Deg=Comp
qua	qua1	ADVrel	MORPH=empty
caudae	cauda	NOMcom	Case=Nom|Numb=Plur
iacent	iaceo	VER	Numb=Plur|Mood=Ind|Tense=Pres|Voice=Act|Person=3
multicolor	multicolor	ADJqua	Case=Nom|Numb=Sing|Gend=Com|Deg=Pos
et	et2	CONcoo	MORPH=empty
discolor	discolor	ADJqua	Case=Nom|Numb=Sing|Gend=Com|Deg=Pos
et	et2	CONcoo	MORPH=empty
versicolor	uersicolor	ADJqua	Case=Nom|Numb=Sing|Gend=Com|Deg=Pos
nunquam	numquam	ADVneg	MORPH=empty
ipsa	ipse	PROdem	Case=Nom|Numb=Sing|Gend=Fem
semper	semper	ADV	Deg=Pos
alia	alius	PROind	Case=Nom|Numb=Sing|Gend=Fem
etsi	etsi2	CONsub	MORPH=empty
semper	semper	ADV	Deg=Pos
ipsa	ipse	PROdem	Case=Nom|Numb=Sing|Gend=Fem
quando	quando3	CONsub	MORPH=empty
alia	alius	PROind	Case=Nom|Numb=Sing|Gend=Fem
totiens	totiens	ADV	Deg=Pos
denique	denique	ADV	Deg=Pos
mutanda	muto2	VER	Case=Nom|Numb=Sing|Gend=Fem|Mood=Adj|Voice=Pass
quotiens	quotiens1	ADVrel	MORPH=empty
movenda	moueo	VER	Case=Acc|Numb=Sing|Gend=Fem|Mood=Adj|Voice=Pass
Nominandus	nomino	VER	Case=Nom|Numb=Sing|Gend=Masc|Mood=Adj|Voice=Pass
est	sum1	VER	Numb=Sing|Mood=Ind|Tense=Pres|Voice=Act|Person=3
et	et2	CONcoo	MORPH=empty
serpens	serpens	NOMcom	Case=Nom|Numb=Sing
licet	licet1	VER	Numb=Sing|Mood=Ind|Tense=Pres|Voice=Act|Person=3
pone	pone?	VER	Numb=Sing|Mood=Imp|Tense=Pres|Voice=Act|Person=2
pavum	pauus	NOMcom	Case=Acc|Numb=Sing|Deg=Pos
na	na	ADVint	MORPH=empty
et	et1	ADV	Deg=Pos
iste	iste	PROdem	Case=Nom|Numb=Sing|Gend=Masc
quod	qui1	PROrel	Case=Acc|Numb=Sing|Gend=Neut
sortitus	sortior	VER	Case=Nom|Numb=Sing|Gend=Masc|Mood=Par|Tense=Perf|Voice=Dep
est	sum1	VER	Numb=Sing|Mood=Ind|Tense=Pres|Voice=Act|Person=3
convertit	conuerto	VER	Numb=Sing|Mood=Ind|Tense=Pres|Voice=Act|Person=3
corium	corium	NOMcom	Case=Acc|Numb=Sing
et	et2	CONcoo	MORPH=empty
aevum	aeuum	NOMcom	Case=Acc|Numb=Sing
Siquidem	siquidem	CONsub	MORPH=empty
ut	ut4	CONsub	MORPH=empty
senium	senium	NOMcom	Case=Acc|Numb=Sing
persensit	persentio	VER	Numb=Sing|Mood=Ind|Tense=Perf|Voice=Act|Person=3
in	in	PRE	MORPH=empty
angustias	angustia	NOMcom	Case=Acc|Numb=Plur
stipat	stipo	VER	Numb=Sing|Mood=Ind|Tense=Pres|Voice=Act|Person=3
pariterque	pariter	ADV	Deg=Pos
{pariterque}	que	CON	MORPH=empty
specum	specus	NOMcom	Case=Acc|Numb=Sing
ingrediens	ingredior	VER	Case=Nom|Numb=Sing|Gend=Com|Mood=Par|Tense=Pres|Voice=Dep
et	et2	CONcoo	MORPH=empty
cutem	cutis	NOMcom	Case=Acc|Numb=Sing
egrediens	egredior	VER	Case=Nom|Numb=Sing|Gend=Com|Mood=Par|Tense=Pres|Voice=Dep
ab	ab	PRE	MORPH=empty
ipso	ipse	PROdem	Case=Abl|Numb=Sing|Gend=MascNeut
statim	statim	ADV	Deg=Pos
limine	limen	NOMcom	Case=Abl|Numb=Sing
erasus	erado	VER	Case=Nom|Numb=Sing|Gend=Masc|Mood=Par|Tense=Perf|Voice=Pass
exuviis	exuuiae	NOMcom	Case=Abl|Numb=Plur
ibidem	ibidem	ADV	Deg=Pos
relictis	relinquo	VER	Case=Abl|Numb=Plur|Gend=Com|Mood=Par|Tense=Perf|Voice=Pass
novus	nouus	ADJqua	Case=Nom|Numb=Sing|Gend=Masc|Deg=Pos
explicat	explico	VER	Numb=Sing|Mood=Ind|Tense=Pres|Voice=Act|Person=3
cum	cum3	CONsub	MORPH=empty
squamis	squama	NOMcom	Case=Abl|Numb=Plur
et	et2	CONcoo	MORPH=empty
anni	annus	NOMcom	Case=Nom|Numb=Plur
recusantur	recuso	VER	Numb=Plur|Mood=Ind|Tense=Pres|Voice=Pass|Person=3
Hyaena	Hyaena	NOMpro	Case=Nom|Numb=Sing
si	si2	CONsub	MORPH=empty
observes	obseruo	VER	Numb=Sing|Mood=Sub|Tense=Pres|Voice=Act|Person=2
sexus	sexus	NOMcom	Case=Nom|Numb=Sing
annalis	annalis1	NOMcom	Case=Nom|Numb=Sing|Gend=MascFem|Deg=Pos
est	sum1	VER	Numb=Sing|Mood=Ind|Tense=Pres|Voice=Act|Person=3
marem	mas	NOMcom	Case=Acc|Numb=Sing
et	et2	CONcoo	MORPH=empty
feminam	femina	NOMcom	Case=Acc|Numb=Sing
alternat	alterno	VER	Numb=Sing|Mood=Ind|Tense=Pres|Voice=Act|Person=3
Taceo	taceo	VER	Numb=Sing|Mood=Ind|Tense=Pres|Voice=Act|Person=1
cervum	ceruus	NOMcom	Case=Acc|Numb=Sing
quod	qui1	PROrel	Numb=Sing|Gend=Neut
et	et2	CONcoo	MORPH=empty
ipse	ipse	PROdem	Case=Nom|Numb=Sing|Gend=Masc
aetatis	aetas	NOMcom	Case=Gen|Numb=Sing
suae	suus	PROpos.ref	Case=Gen|Numb=Sing|Gend=Fem
arbiter	arbiter	NOMcom	Case=Nom|Numb=Sing
serpente	serpens	NOMcom	Case=Abl|Numb=Sing
pastus	pascor	VER	Case=Nom|Numb=Sing|Gend=Masc|Mood=Par|Tense=Perf|Voice=Dep
veneno	uenenum	NOMcom	Case=Abl|Numb=Sing
languescit	languesco	VER	Numb=Sing|Mood=Ind|Tense=Pres|Voice=Act|Person=3
in	in	PRE	MORPH=empty
iuventutem	iuuentus	NOMcom	Case=Acc|Numb=Sing
Est	sum1	VER	Numb=Sing|Mood=Ind|Tense=Pres|Voice=Act|Person=3
et	et2	CONcoo	MORPH=empty
Quadrupes	quadrupes1	NOMcom	Numb=Sing
tardigrada	tardigradus	ADJqua	Case=Nom|Numb=Sing|Gend=Fem|Deg=Pos
agrestis	agrestis2	ADJqua	Case=Nom|Numb=Sing|Gend=MascFem
humilis	humilis	ADJqua	Case=Nom|Numb=Sing|Gend=MascFem|Deg=Pos
aspera	asper	ADJqua	Case=Nom|Numb=Sing|Gend=Fem
Testudinem	testudo	NOMcom	Case=Acc|Numb=Sing
Pacuvianam	Pacuuianus	ADJqua	Case=Acc|Numb=Sing|Gend=Fem|Deg=Pos
putas	puto	VER	Numb=Sing|Mood=Ind|Tense=Pres|Voice=Act|Person=2
Non	non	ADVneg	MORPH=empty
est	sum1	VER	Numb=Sing|Mood=Ind|Tense=Pres|Voice=Act|Person=3
Capit	capio2	VER	Numb=Sing|Mood=Ind|Tense=Pres|Voice=Act|Person=3
et	et2	CONcoo	MORPH=empty
alia	alius	PROind	Case=Nom|Numb=Sing|Gend=Fem
bestiola	bestiola	NOMcom	Case=Nom|Numb=Sing
versiculum	uersiculus	NOMcom	Case=Acc|Numb=Sing
de	de	PRE	MORPH=empty
mediocribus	mediocris	ADJqua	Case=Abl|Numb=Plur|Gend=Com|Deg=Pos
oppido	oppidum	NOMcom	Numb=Sing
sed	sed	CONcoo	MORPH=empty
nomen	nomen	NOMcom	Case=Acc|Numb=Sing
grande	grandis	ADJqua	Case=Nom|Numb=Sing|Gend=Neut|Deg=Pos
Chamaeleontem	chamaeleon	NOMcom	Case=Acc|Numb=Sing
qui	qui1	PROrel	Case=Nom|Numb=Sing|Gend=Masc
audieris	audio	VER	Numb=Sing|Mood=Ind|Tense=FutAnt|Voice=Act|Person=2
haud	haud	ADVneg	MORPH=empty
ante	ante1	ADV	Deg=Pos
gnarus	gnarus	ADJqua	Case=Nom|Numb=Sing|Gend=Masc|Deg=Pos
iam	iam	ADV	Deg=Pos
timebis	timeo	VER	Numb=Sing|Mood=Ind|Tense=Fut|Voice=Act|Person=2
aliquid	aliquis	PROind	Case=Acc|Numb=Sing|Gend=Neut
amplius	amplus	ADJqua	Case=Acc|Deg=Comp
cum	cum2	PRE	MORPH=empty
leone	leo	NOMcom	Case=Abl|Numb=Sing
At	at2	CONcoo	MORPH=empty
cum	cum3	CONsub	MORPH=empty
offenderis	offendo	VER	Numb=Sing|Mood=Ind|Tense=FutAnt|Voice=Act|Person=2
apud	apud	PRE	MORPH=empty
vineam	uinea	NOMcom	Case=Acc|Numb=Sing
ferme	ferme	ADV	Deg=Pos
sub	sub	PRE	MORPH=empty
pampino	pampinus	NOMcom	Case=Abl|Numb=Sing
totum	totus	PROind	Case=Acc|Numb=Sing|Gend=MascNeut
ridebis	rideo	VER	Numb=Sing|Mood=Ind|Tense=Fut|Voice=Act|Person=2
illico	illico	ADV	Deg=Pos
audaciam	audacia	NOMcom	Case=Acc|Numb=Sing
egregiam	egregius	ADJqua	Case=Acc|Numb=Sing|Gend=Fem|Deg=Pos
nominis	nomen	NOMcom	Case=Gen|Numb=Sing
quippe	quippe2	CONcoo	MORPH=empty
nec	nec2	CONcoo	MORPH=empty
sucus	sucus	NOMcom	Case=Nom|Numb=Sing
est	sum1	VER	Numb=Sing|Mood=Ind|Tense=Pres|Voice=Act|Person=3
corpori	corpus	NOMcom	Case=Dat|Numb=Sing
quod	qui1	PROrel	Case=Nom|Numb=Sing
minutioribus	minutus2	ADJqua	Case=Abl|Numb=Plur|Gend=Com|Deg=Comp
multo	multo2	ADV	Deg=Pos
liquet	liqueo	VER	Numb=Sing|Mood=Ind|Tense=Pres|Voice=Act|Person=3
Chamaeleon	chamaeleon	NOMpro	Case=Nom|Numb=Sing
pellicula	pellicula	NOMcom	Case=Nom|Numb=Sing
vivit	uiuo	VER	Numb=Sing|Mood=Ind|Tense=Pres|Voice=Act|Person=3
Capitulum	capitulum	NOMcom	Case=Acc|Numb=Sing
statim	statim	ADV	Deg=Pos
a	ab	PRE	MORPH=empty
dorso	dorsum	NOMcom	Case=Abl|Numb=Sing
nam	nam	CONcoo	MORPH=empty
deficit	deficio	VER	Numb=Sing|Mood=Ind|Tense=Pres|Voice=Act|Person=3
cervix	ceruix	NOMcom	Case=Nom|Numb=Sing
Itaque	itaque	CONcoo	MORPH=empty
durum	durus	ADJqua	Case=Acc|Numb=Sing|Gend=MascNeut|Deg=Pos
reflecti	reflecto	VER	Case=Nom|Gend=Masc|Mood=Inf|Tense=Pres|Voice=Pass
sed	sed	CONcoo	MORPH=empty
circumspectu	circumspectus1	NOMcom	Case=Abl|Numb=Sing
emissicii	emissicius	ADJqua	Case=Nom|Numb=Sing|Gend=Masc|Deg=Pos
ocelli	ocellus	NOMcom	Case=Nom|Numb=Sing
immo	immo	ADV	Deg=Pos
luminis	lumen	NOMcom	Case=Gen|Numb=Sing
puncta	punctum	NOMcom	Case=Nom|Numb=Plur
vertiginant	uertigino	VER	Numb=Plur|Mood=Ind|Tense=Pres|Voice=Act|Person=3
Hebes	hebes	ADJqua	Case=Nom|Numb=Sing|Gend=Com|Deg=Pos
fessus	fessus	ADJqua	Case=Nom|Numb=Sing|Gend=Masc|Deg=Pos
vix	uix	ADV	Deg=Pos
a	ab	PRE	MORPH=empty
terra	terra	NOMcom	Case=Abl|Numb=Sing
suspendit	suspendo	VER	Numb=Sing|Mood=Ind|Tense=Pres|Voice=Act|Person=3
molitur	molior	VER	Numb=Sing|Mood=Ind|Tense=Pres|Voice=Dep|Person=3
incessum	incessus	NOMcom	Case=Acc|Numb=Sing
stupens	stupeo	VER	Case=Nom|Numb=Sing|Gend=Com|Mood=Par|Tense=Pres|Voice=Act
et	et2	CONcoo	MORPH=empty
promovet	promoueo	VER	Numb=Sing|Mood=Ind|Tense=Pres|Voice=Act|Person=3
gradum	gradus	NOMcom	Case=Acc|Numb=Sing
magis	magis2	ADV	Deg=Comp
demonstrat	demonstro	VER	Numb=Sing|Mood=Ind|Tense=Pres|Voice=Act|Person=3
quam	quam1	ADVrel	Case=Acc
explicat	explico	VER	Numb=Sing|Mood=Ind|Tense=Pres|Voice=Act|Person=3
ieiunus	ieiunus	ADJqua	Case=Nom|Numb=Sing|Gend=Masc|Deg=Pos
scilicet	scilicet	ADV	Deg=Pos
semper	semper	ADV	Deg=Pos
et	et2	CONcoo	MORPH=empty
indefectus	indefectus	ADJqua	Case=Nom|Numb=Sing|Gend=Masc|Deg=Pos
oscitans	oscitans	VER	Case=Nom|Numb=Sing|Gend=Com|Mood=Par|Tense=Pres|Voice=Act
vescitur	uescor	VER	Numb=Sing|Mood=Ind|Tense=Pres|Voice=Dep|Person=3
follicans	follico	VER	Case=Nom|Numb=Sing|Gend=Com|Mood=Par|Tense=Pres|Voice=Act
ruminat	rumino	VER	Numb=Sing|Mood=Ind|Tense=Pres|Voice=Act|Person=3
de	de	PRE	MORPH=empty
vento	uentus	NOMcom	Case=Abl|Numb=Sing
cibus	cibus	NOMcom	Case=Nom|Numb=Sing
Tamen	tamen	ADV	Deg=Pos
et	et2	CONcoo	MORPH=empty
chamaeleon	chamaeleon	NOMcom	Case=Acc|Numb=Sing
mutare	muto2	VER	Mood=Inf|Tense=Pres|Voice=Act
totus	totus	PROind	Case=Nom|Numb=Sing|Gend=Masc
nec	nec2	CONcoo	MORPH=empty
aliud	alius	PROind	Case=Acc|Numb=Sing|Gend=Neut
valet	ualeo	VER	Numb=Sing|Mood=Ind|Tense=Pres|Voice=Act|Person=3
Nam	nam	CONcoo	MORPH=empty
cum	cum3	CONsub	MORPH=empty
illi	ille	PROdem	Case=Dat|Numb=Sing|Gend=Com
coloris	color	NOMcom	Case=Gen|Numb=Sing
proprietas	proprietas	NOMcom	Case=Nom|Numb=Sing
una	unus	ADJcar	Case=Nom|Numb=Sing|Gend=Fem|Deg=Pos
sit	sum1	VER	Numb=Sing|Mood=Sub|Tense=Pres|Voice=Act|Person=3
ut	ut4	CONsub	MORPH=empty
quid	quis2	PROind	Case=Nom|Numb=Sing|Gend=Neut
accessit	accedo1	VER	Numb=Sing|Mood=Ind|Tense=Perf|Voice=Act|Person=3
inde	inde	ADV	Deg=Pos
suffunditur	suffundo2	VER	Numb=Sing|Mood=Ind|Tense=Pres|Voice=Pass|Person=3
Hoc	hic1	PROdem	Case=Nom|Numb=Sing|Gend=Neut
soli	solus	PROind	Case=Dat|Numb=Sing|Gend=Com
chamaeleonti	chamaeleon	NOMcom	Case=Dat|Numb=Sing
datum	do	VER	Case=Nom|Numb=Sing|Gend=Neut|Mood=Par|Tense=Perf|Voice=Pass
quod	qui1	PROrel	Case=Nom|Numb=Sing|Gend=Neut
vulgo	uulgo2	ADV	Deg=Pos
dictum	dico2	VER	Case=Nom|Numb=Sing|Gend=Neut|Mood=Par|Tense=Perf|Voice=Pass
est	sum1	VER	Numb=Sing|Mood=Ind|Tense=Pres|Voice=Act|Person=3
de	de	PRE	MORPH=empty
corio	corium	NOMcom	Case=Abl|Numb=Sing
suo	suus	PROpos.ref	Case=Abl|Numb=Sing|Gend=MascNeut
ludere	ludo	VER	Mood=Inf|Tense=Pres|Voice=Act
Multa	multus	ADJqua	Case=Acc|Numb=Plur|Gend=Neut|Deg=Pos
dicendum	dico2	VER	Case=Nom|Numb=Sing|Gend=Neut|Mood=Adj|Voice=Pass
fuit	sum1	VER	Numb=Sing|Mood=Ind|Tense=Perf|Voice=Act|Person=3
ut	ut4	CONsub	MORPH=empty
ad	ad2	PRE	MORPH=empty
hominem	homo	NOMcom	Case=Acc|Numb=Sing
praestructim	praestructim	ADV	Deg=Pos
perveniretur	peruenio	VER	Numb=Sing|Mood=Sub|Tense=Impa|Voice=Pass|Person=3
Hunc	hic1	PROdem	Case=Acc|Numb=Sing|Gend=Masc
quoquo	quoquo	ADV	Case=Abl|Numb=Sing
primordio	primordium	NOMcom	Case=Abl|Numb=Sing
accipitis	accipio	VER	Numb=Plur|Mood=Ind|Tense=Pres|Voice=Act|Person=2
nudus	nudus	ADJqua	Case=Nom|Numb=Sing|Gend=Masc|Deg=Pos
certe	certe	ADV	Deg=Pos
et	et2	CONcoo	MORPH=empty
investis	inuestis	VER	Case=Dat|Numb=Sing|Deg=Pos
figulo	figulus	NOMcom	Case=Dat|Numb=Sing
suo	suus	PROpos.ref	Case=Dat|Numb=Sing|Gend=MascNeut
constitit	consisto	VER	Numb=Sing|Mood=Ind|Tense=Perf|Voice=Act|Person=3
post	post2	PRE	MORPH=empty
demum	demum	ADV	Deg=Pos
sapientiam	sapientia	NOMcom	Case=Acc|Numb=Sing
haud	haud	ADVneg	MORPH=empty
dum	dum2	CONsub	MORPH=empty
licitum	licet1	VER	Numb=Sing|Gend=Neut|Deg=Pos|Mood=Par|Tense=Perf|Voice=Pass
praereptam	praeripio	VER	Case=Acc|Numb=Sing|Gend=Fem|Mood=Par|Tense=Perf|Voice=Pass
potitur	potior	VER	Numb=Sing|Mood=Ind|Tense=Pres|Voice=Dep|Person=3
Ibidem	ibidem	ADV	Deg=Pos
quod	qui1	CONsub	Case=Nom|Numb=Sing|Gend=Neut
in	in	PRE	MORPH=empty
novo	nouus	ADJqua	Case=Abl|Numb=Sing|Gend=MascNeut|Deg=Pos
corpore	corpus	NOMcom	Case=Abl|Numb=Sing
indebitum	indebitus	ADJqua	Case=Nom|Numb=Sing|Gend=Neut|Deg=Pos|Mood=Par|Tense=Perf|Voice=Pass
adhuc	adhuc	ADV	Deg=Pos
pudori	pudor	NOMcom	Case=Dat|Numb=Sing
erat	sum1	VER	Numb=Sing|Mood=Ind|Tense=Impa|Voice=Act|Person=3
protegere	protego	VER	Mood=Inf|Tense=Pres|Voice=Act
festinans	festino	VER	Case=Nom|Numb=Sing|Gend=Com|Mood=Par|Tense=Pres|Voice=Act
ficulneis	ficulneus	ADJqua	Case=Abl|Numb=Plur|Gend=Com|Deg=Pos
foliis	folium	NOMcom	Case=Abl|Numb=Plur
interim	interim	ADV	Deg=Pos
circumdat	circumdo	VER	Numb=Sing|Mood=Ind|Tense=Pres|Voice=Act|Person=3
dehinc	dehinc	ADV	Deg=Pos
cum	cum3	CONsub	MORPH=empty
de	de	PRE	MORPH=empty
originis	origo	NOMcom	Case=Gen|Numb=Sing
loco	locus	NOMcom	Case=Abl|Numb=Sing
exterminat	extermino	VER	Numb=Sing|Mood=Ind|Tense=Pres|Voice=Act|Person=3
quippe	quippe2	CONcoo	MORPH=empty
deliquerat	delinquo	VER	Numb=Sing|Mood=Ind|Tense=Pqp|Voice=Act|Person=3
pellitus	pellitus	ADJqua	Case=Nom|Numb=Sing|Gend=Masc|Deg=Pos
orbi	orbis	NOMcom	Case=Dat|Numb=Sing
ut	ut1	ADVrel	MORPH=empty
metallo	metallum	NOMcom	Case=Dat|Numb=Sing
datur	do	VER	Numb=Sing|Mood=Ind|Tense=Pres|Voice=Pass|Person=3
Sed	sed	CONcoo	MORPH=empty
arcana	arcanum	NOMcom	Case=Acc|Numb=Plur|Deg=Pos
ista	iste	PROdem	Case=Acc|Numb=Plur|Gend=Neut
nec	nec2	CONcoo	MORPH=empty
omnium	omnis	PROind	Case=Gen|Numb=Plur|Gend=Com
nosse	nosco	VER	Mood=Inf|Tense=Perf|Voice=Act
Cedo	cedo2	NOMcom	MORPH=empty
iam	iam	ADV	Deg=Pos
de	de	PRE	MORPH=empty
vestro	uester	PROpos	Case=Abl|Numb=Sing|Gend=MascNeut
quod	qui1	PROrel	Case=Acc|Numb=Sing|Gend=Neut
Aegyptii	Aegyptii	NOMpro	Case=Nom|Numb=Plur
narrant	narro	VER	Numb=Plur|Mood=Ind|Tense=Pres|Voice=Act|Person=3
et	et2	CONcoo	MORPH=empty
Alexander	Alexander	NOMpro	Case=Nom|Numb=Sing
digerit	digero	VER	Numb=Sing|Mood=Ind|Tense=Pres|Voice=Act|Person=3
et	et2	CONcoo	MORPH=empty
mater	mater	NOMcom	Case=Nom|Numb=Sing
legit	lego2	VER	Numb=Sing|Mood=Ind|Tense=Pres|Voice=Act|Person=3
de	de	PRE	MORPH=empty
tempestate	tempestas	NOMcom	Case=Abl|Numb=Sing
Osiridis	Osiris	NOMpro	Case=Gen|Numb=Sing
qua	qui1	PROrel	Case=Abl|Numb=Sing|Gend=Fem
ad	ad2	PRE	MORPH=empty
illum	ille	PROdem	Case=Acc|Numb=Sing|Gend=Masc
ex	ex	PRE	MORPH=empty
Libya	Libya	NOMpro	Case=Abl|Numb=Sing
Ammon	Ammon	NOMpro	Case=Nom|Numb=Sing
facit	facio	VER	Numb=Sing|Mood=Ind|Tense=Pres|Voice=Act|Person=3
ovium	ouis	NOMcom	Case=Gen|Numb=Plur
dives	diues	ADJqua	Case=Nom|Numb=Sing|Gend=Com|Deg=Pos
Denique	denique	ADV	Deg=Pos
cum	cum2	PRE	MORPH=empty
ipsis	ipse	PROdem	Case=Abl|Numb=Plur|Gend=Com
Mercurium	Mercurius	NOMpro	Case=Acc|Numb=Sing
autumant	autumo	VER	Numb=Plur|Mood=Ind|Tense=Pres|Voice=Act|Person=3
forte	forte	ADV	Deg=Pos
palpati	palpo2	VER	Case=Gen|Numb=Sing|Gend=MascNeut|Mood=Par|Tense=Perf|Voice=Pass
arietis	aries	NOMcom	Case=Gen|Numb=Sing
mollitie	mollities	NOMcom	Case=Abl|Numb=Sing
delectatum	delecto	VER	Case=Acc|Numb=Sing|Gend=MascNeut|Mood=Par|Tense=Perf|Voice=Pass
deglubasse	deglubo	VER	Mood=Inf|Tense=Perf|Voice=Act
oviculam	ouicula	NOMcom	Case=Acc|Numb=Sing
dumque	dum	CONsub	MORPH=empty
{dumque}	que	CON	MORPH=empty
pertemptat	pertento	VER	Numb=Sing|Mood=Ind|Tense=Pres|Voice=Act|Person=3
et	et2	CONcoo	MORPH=empty
quod	qui1	CONsub	Case=Acc|Numb=Sing|Gend=Neut
facilitas	facilitas	NOMcom	Case=Nom|Numb=Sing
materiae	materia	NOMcom	Case=Gen|Numb=Sing
suadebat	suadeo	VER	Numb=Sing|Mood=Ind|Tense=Impa|Voice=Act|Person=3
tractu	tractus	NOMcom	Case=Abl|Numb=Sing
prosequente	prosequor	VER	Case=Abl|Numb=Sing|Gend=Com|Mood=Par|Tense=Pres|Voice=Dep
filum	filum	NOMcom	Case=Acc|Numb=Sing
eliquat	eliquo	VER	Numb=Sing|Mood=Ind|Tense=Pres|Voice=Act|Person=3
in	in	PRE	MORPH=empty
retis	rete	NOMcom	Case=Gen|Numb=Plur
pristini	pristinus	ADJqua	Case=Gen|Numb=Sing|Gend=MascNeut|Deg=Pos
modum	modus	NOMcom	Case=Acc|Numb=Sing
quem	qui1	PROrel	Case=Acc|Numb=Sing|Gend=Masc
philyrae	philyra	NOMcom	Case=Gen|Numb=Sing
taeniis	taenia	NOMcom	Case=Abl|Numb=Plur
iunxerat	iungo	VER	Numb=Sing|Mood=Ind|Tense=Pqp|Voice=Act|Person=3
texuisse	texo	VER	Mood=Inf|Tense=Perf|Voice=Act
Sed	sed	CONcoo	MORPH=empty
vos	uos	PROper	Case=Nom|Numb=Plur
omnem	omnis	PROind	Case=Acc|Numb=Sing|Gend=MascFem
lanicii	lanitium	NOMcom	Case=Gen|Numb=Sing
dispensationem	dispensatio	NOMcom	Case=Acc|Numb=Sing
structuramque	structura	NOMcom	Case=Acc|Numb=Sing
{structuramque}	que	CON	MORPH=empty
telarum	tela	NOMcom	Case=Gen|Numb=Plur
Minervae	Minerua	NOMpro	Case=Gen|Numb=Sing
maluistis	malo	VER	Numb=Plur|Mood=Ind|Tense=Perf|Voice=Act|Person=2
cum	cum3	CONsub	MORPH=empty
penes	penes	PRE	MORPH=empty
Arachnen	Arachne	NOMpro	Case=Acc|Numb=Sing
diligentior	diligens	ADJqua	Case=Nom|Numb=Sing|Gend=MascFem|Deg=Comp
officina	officina	NOMcom	Case=Abl|Numb=Sing
Exinde	exinde	ADV	Deg=Pos
materia	materia	NOMcom	Case=Abl|Numb=Sing
nec	nec2	CONcoo	MORPH=empty
de	de	PRE	MORPH=empty
ovibus	ouis	NOMcom	Case=Abl|Numb=Plur
dico	dico2	VER	Numb=Sing|Mood=Ind|Tense=Pres|Voice=Act|Person=1
Milesiis	Milesius	NOMpro	Case=Abl|Numb=Plur|Gend=Com
et	et2	CONcoo	MORPH=empty
Selgicis	Selgicus	NOMpro	Case=Abl|Numb=Plur
et	et2	CONcoo	MORPH=empty
Altinis	Altinus	NOMpro	Case=Abl|Numb=Plur
aut	aut	CONcoo	MORPH=empty
quis	qui1	PROrel	Case=Abl|Numb=Sing|Gend=Com
Tarentum	Tarentum	NOMpro	Case=Gen|Numb=Sing
vel	uel2	CONcoo	MORPH=empty
Baetica	Baetica	NOMpro	Case=Nom|Numb=Sing
cluet	clueo	VER	Numb=Sing|Mood=Ind|Tense=Pres|Voice=Act|Person=3
natura	natura	NOMcom	Case=Abl|Numb=Sing
colorante	coloro	ADJqua	Case=Abl|Numb=Sing|Gend=Com|Mood=Par|Tense=Pres|Voice=Act
sed	sed	CONcoo	MORPH=empty
quoniam	quoniam	CONsub	MORPH=empty
et	et2	CONcoo	MORPH=empty
arbusta	arbustum	NOMcom	Case=Nom|Numb=Plur
vestiunt	uestio	VER	Numb=Plur|Mood=Ind|Tense=Pres|Voice=Act|Person=3
et	et2	CONcoo	MORPH=empty
lini	linum	NOMcom	Case=Gen|Numb=Sing
herbida	herbidus	ADJqua	Case=Nom|Numb=Plur|Gend=Neut|Deg=Pos
post	post2	PRE	MORPH=empty
virorem	uiror	NOMcom	Case=Acc|Numb=Sing
lavacro	lauacrum	NOMcom	Case=Abl|Numb=Sing
nivescunt	niuesco	VER	Numb=Plur|Mood=Ind|Tense=Pres|Voice=Act|Person=3
nec	nec2	CONcoo	MORPH=empty
fuit	sum1	VER	Numb=Sing|Mood=Ind|Tense=Perf|Voice=Act|Person=3
satis	satis1	ADJqua	Deg=Pos
tunicam	tunica	NOMcom	Case=Acc|Numb=Sing
pangere	pango	VER	Mood=Inf|Tense=Pres|Voice=Act
et	et2	CONcoo	MORPH=empty
serere	sero3	VER	Mood=Inf|Tense=Pres|Voice=Act
ni	ni2	CONsub	MORPH=empty
etiam	etiam	ADV	Deg=Pos
piscari	piscor	VER	Case=Abl|Mood=Inf|Tense=Pres|Voice=Dep
vestitum	uestitus1	NOMcom	Case=Acc|Numb=Sing
contigisset	contingo1	VER	Numb=Sing|Mood=Sub|Tense=Pqp|Voice=Act|Person=3
Nam	nam	CONcoo	MORPH=empty
et	et2	CONcoo	MORPH=empty
de	de	PRE	MORPH=empty
mari	mare	NOMcom	Case=Abl|Numb=Sing
vellera	uellus	NOMcom	Case=Acc|Numb=Plur
qua	qua1	ADVrel	MORPH=empty
muscosae	muscosus	ADJqua	Case=Nom|Numb=Sing|Gend=Fem
lanositatis	lanositas	NOMcom	Case=Gen|Numb=Sing
lautiores	lautus	ADJqua	Case=Nom|Numb=Plur|Gend=MascFem|Deg=Comp
conchae	concha	NOMcom	Case=Nom|Numb=Plur
comant	como?	VER	Numb=Plur|Mood=Ind|Tense=Pres|Voice=Act|Person=3
Prorsus	prorsus2	ADV	Deg=Pos
haud	haud	ADVneg	MORPH=empty
latet	lateo	VER	Numb=Sing|Mood=Ind|Tense=Pres|Voice=Act|Person=3
bombycem	bombyx	NOMcom	Case=Acc|Numb=Sing
vermiculi	uermiculus	NOMcom	Case=Gen|Numb=Sing
genus	genus1	NOMcom	Case=Nom|Numb=Sing
est	sum1	VER	Numb=Sing|Mood=Ind|Tense=Pres|Voice=Act|Person=3
quae	qui1	PROrel	Case=Nom|Numb=Sing|Gend=Neut
per	per	PRE	MORPH=empty
aerem	aer	NOMcom	Case=Acc|Numb=Sing
liquando	liquo	VER	Case=Abl|Numb=Sing|Gend=MascNeut|Mood=Ger|Voice=Act
araneorum	araneus1	NOMcom	Case=Gen|Numb=Plur
horoscopis	horoscopus	NOMcom	Case=Abl|Numb=Plur
idonius	idonee	ADV	Deg=Comp
distendit	distendo	VER	Numb=Sing|Mood=Ind|Tense=Pres|Voice=Act|Person=3
dehinc	dehinc	ADV	Deg=Pos
devorat	deuoro	VER	Numb=Sing|Mood=Ind|Tense=Pres|Voice=Act|Person=3
moi	moueo	NOMcom	Case=Gen|Numb=Sing
salva	saluus	ADJqua	Case=Acc|Numb=Plur|Deg=Pos
reddere	reddo	VER	Mood=Inf|Tense=Pres|Voice=Act
Proinde	proinde	ADV	Deg=Pos
si	si2	CONsub	MORPH=empty
necaveris	neco	VER	Numb=Sing|Mood=Ind|Tense=FutAnt|Voice=Act|Person=2
animata	animatus	ADJqua	Case=Acc|Numb=Plur|Gend=Neut|Deg=Pos
iam	iam	ADV	Deg=Pos
stamina	stamen	NOMcom	Case=Acc|Numb=Plur
volves	uoluo	VER	Numb=Sing|Mood=Ind|Tense=Fut|Voice=Act|Person=2
Tantam	tantus	PROdem	Case=Acc|Numb=Sing|Gend=Fem
igitur	igitur	CONcoo	MORPH=empty
paraturam	paratura	VER	Case=Acc|Numb=Sing|Gend=Fem|Mood=Par|Tense=Fut|Voice=Act
materiarum	materia	NOMcom	Case=Gen|Numb=Plur
ingenia	ingenium	NOMcom	Case=Acc|Numb=Plur
quoque	quoque	ADV	Deg=Pos
vestificinae	uestificina	NOMcom	Case=Dat|Numb=Sing
prosecuta	prosequor	VER	Case=Acc|Numb=Plur|Gend=Neut|Mood=Par|Tense=Perf|Voice=Dep
primum	primum	ADJadv.ord	Deg=Sup
tegendo	tego	VER	Case=Dat|Numb=Sing|Mood=Ger|Voice=Act
homini	homo	NOMcom	Case=Dat|Numb=Sing
qua	qui2	ADVrel	MORPH=empty
necessitas	necessitas	NOMcom	Case=Nom|Numb=Sing
praecessit	praecedo1	VER	Numb=Sing|Mood=Ind|Tense=Perf|Voice=Act|Person=3
dehinc	dehinc	ADV	Deg=Pos
et	et2	CONcoo	MORPH=empty
ornando	orno	VER	Case=Abl|Numb=Sing|Mood=Ger|Voice=Act
immo	immo	ADV	Deg=Pos
et	et2	CONcoo	MORPH=empty
inflando	inflo	VER	Case=Abl|Numb=Sing|Mood=Ger|Voice=Act
qua	qua1	ADVrel	MORPH=empty
ambitio	ambitio	NOMcom	Case=Nom|Numb=Sing
successit	succedo1	VER	Numb=Sing|Mood=Ind|Tense=Perf|Voice=Act|Person=3
varias	uarius	ADJqua	Case=Acc|Numb=Plur|Gend=Fem|Deg=Pos
indumentorum	indumentum	NOMcom	Case=Gen|Numb=Plur
formas	forma	NOMcom	Case=Acc|Numb=Plur
promulgare	promulgo	VER	Mood=Inf|Tense=Pres|Voice=Act
Quarum	qui1	PROrel	Case=Gen|Numb=Plur|Gend=Fem
pars	pars	NOMcom	Case=Nom|Numb=Sing
gentilitus	gentilitus	NOMcom	MORPH=empty
inhabitantur	inhabito	VER	Numb=Plur|Mood=Ind|Tense=Pres|Voice=Pass|Person=3
ceteris	ceteri	NOMcom	Case=Dat|Numb=Plur|Gend=Com|Deg=Pos
incommunes	incommunis	ADJqua	Case=Nom|Numb=Plur|Gend=MascFem|Deg=Pos
pars	pars	NOMcom	Case=Nom|Numb=Sing
vero	uero4	CONcoo	MORPH=empty
passivitus	passiuitus	ADV	MORPH=empty
omnibus	omnis	PROind	Case=Dat|Numb=Plur|Gend=Com
utiles	utilis	ADJqua	Case=Nom|Numb=Plur|Gend=MascFem|Deg=Pos
ut	ut1	ADVrel	MORPH=empty
hoc	hic1	PROdem	Case=Nom|Numb=Sing|Gend=Neut
pallium	pallium	NOMcom	Case=Nom|Numb=Sing
etsi	etsi2	CONsub	MORPH=empty
Graecum	Graecus	ADJqua	Case=Nom|Numb=Sing|Gend=Neut|Deg=Pos
magis	magis2	ADV	Deg=Comp
sed	sed	CONcoo	MORPH=empty
lingua	lingua	NOMcom	Case=Abl|Numb=Sing
iam	iam	ADV	Deg=Pos
penes	penes	PRE	MORPH=empty
Latium	Latium	NOMpro	Case=Acc|Numb=Sing
est	sum1	VER	Numb=Sing|Mood=Ind|Tense=Pres|Voice=Act|Person=3
Cum	cum2	PRE	MORPH=empty
voce	uox	NOMcom	Case=Abl|Numb=Sing
vestis	uestis	NOMcom	Case=Nom|Numb=Sing
intravit	intro1	VER	Numb=Sing|Mood=Ind|Tense=Perf|Voice=Act|Person=3
Atque	atque1	CONcoo	MORPH=empty
adeo	adeo2	ADV	Deg=Pos
ipse	ipse	PROdem	Case=Nom|Numb=Sing|Gend=Masc
qui	qui1	PROrel	Case=Nom|Numb=Sing|Gend=Masc
Graecos	Graeci	NOMpro	Case=Acc|Numb=Plur
praeter	praeter2	PRE	MORPH=empty
urbem	urbs	NOMcom	Case=Acc|Numb=Sing
censebat	censeo	VER	Numb=Sing|Mood=Ind|Tense=Impa|Voice=Act|Person=3
litteras	littera	NOMcom	Case=Acc|Numb=Plur
eorum	is	PROdem	Case=Gen|Numb=Plur|Gend=MascNeut
vocemque	uox	NOMcom	Case=Acc|Numb=Sing
{vocemque}	que	CON	MORPH=empty
senex	senex2	ADJqua	Case=Nom|Numb=Sing|Deg=Pos
iam	iam	ADV	Deg=Pos
eruditus	erudio	ADJqua	Case=Nom|Numb=Sing|Gend=Masc|Deg=Pos
idem	idem	PROdem	Case=Nom|Numb=Sing|Gend=MascNeut
Cato	Cato	NOMpro	Case=Nom|Numb=Sing
iuridicinae	iuridicina	NOMcom	Case=Gen|Numb=Sing
suae	suus	PROpos.ref	Case=Gen|Numb=Sing|Gend=Fem
in	in	PRE	MORPH=empty
tempore	tempus1	NOMcom	Case=Abl|Numb=Sing
humerum	humerus	NOMcom	Case=Acc|Numb=Sing
exertus	exsertus	VER	Case=Nom|Numb=Sing|Gend=Masc|Deg=Pos|Mood=Par|Tense=Perf|Voice=Pass
haud	haud	ADVneg	MORPH=empty
minus	parum2	ADV	Deg=Comp
palliato	palliatus	ADJqua	Case=Abl|Numb=Sing|Gend=MascNeut|Deg=Pos
habitu	habitus1	NOMcom	Case=Abl|Numb=Sing
Graecis	Graeci	NOMpro	Case=Dat|Numb=Plur
favit	faueo	VER	Numb=Sing|Mood=Ind|Tense=Perf|Voice=Act|Person=3
Quid	quis1	PROint	Case=Acc|Numb=Sing|Gend=Neut
nunc	nunc	ADV	Deg=Pos
si	si2	CONsub	MORPH=empty
est	sum1	VER	Numb=Sing|Mood=Ind|Tense=Pres|Voice=Act|Person=3
Romanitas	Romanitas	NOMcom	Case=Nom|Numb=Sing|Gend=Fem
omni	omnis	PROind	Case=Abl|Numb=Sing|Gend=Com
salus	salus	NOMcom	Case=Nom|Numb=Sing
nec	nec2	CONcoo	MORPH=empty
honestis	honestus	NOMcom	Case=Dat|Numb=Plur|Gend=Com|Deg=Pos
tamen	tamen	ADV	Deg=Pos
admodum	admodum	ADV	Deg=Pos
Graeci	Graeci	NOMpro	Case=Nom|Numb=Plur|Gend=Masc
estis	sum1	VER	Numb=Plur|Mood=Ind|Tense=Pres|Voice=Act|Person=2
Aut	aut	CONcoo	MORPH=empty
ni	ni2	CONsub	MORPH=empty
ita	ita	ADV	Deg=Pos
est	sum1	VER	Numb=Sing|Mood=Ind|Tense=Pres|Voice=Act|Person=3
unde	unde1	ADVrel	MORPH=empty
gentium	gens	NOMcom	Case=Gen|Numb=Plur
in	in	PRE	MORPH=empty
provinciis	prouincia	NOMcom	Case=Abl|Numb=Plur
melius	bene	ADV	Deg=Comp
exercitis	exerceo	VER	Case=Dat|Numb=Plur|Gend=Com|Mood=Par|Tense=Perf|Voice=Pass|Person=2
quas	qui1	PROrel	Case=Acc|Numb=Plur|Gend=Fem
natura	natura	NOMcom	Case=Nom|Numb=Sing
agro	ager	NOMcom	Case=Abl|Numb=Sing
potius	potius	ADV	Deg=Comp
eluctando	eluctor	VER	Case=Abl|Numb=Sing|Mood=Ger|Voice=Dep
commodavit	commodo1	VER	Numb=Sing|Mood=Ind|Tense=Perf|Voice=Act|Person=3
studia	studium	NOMcom	Case=Acc|Numb=Plur
palaestrae	palaestra	NOMcom	Case=Gen|Numb=Sing
male	male	ADV	Deg=Pos
senescentia	senesco	VER	Case=Nom|Numb=Plur|Gend=Neut|Mood=Par|Tense=Pres|Voice=Act
et	et2	CONcoo	MORPH=empty
cassum	cassus	ADJqua	Case=Nom|Numb=Sing|Gend=Neut|Deg=Pos
laborantia	laboro	VER	Case=Nom|Numb=Plur|Mood=Par|Tense=Pres|Voice=Act
et	et2	CONcoo	MORPH=empty
lutea	luteus2	ADJqua	Case=Nom|Numb=Sing|Gend=Fem|Deg=Pos
unctio	unctio	NOMcom	Case=Nom|Numb=Sing
et	et2	CONcoo	MORPH=empty
pulverea	puluereus	ADJqua	Case=Nom|Numb=Sing|Gend=Fem|Deg=Pos
volutatio	uolutatio	NOMcom	Case=Nom|Numb=Sing
et	et2	CONcoo	MORPH=empty
arida	aridus	ADJqua	Case=Nom|Numb=Sing|Gend=Fem|Deg=Pos
saginatio	saginatio	NOMcom	Case=Nom|Numb=Sing
unde	unde1	ADVrel	MORPH=empty
apud	apud	PRE	MORPH=empty
aliquos	aliquis	PROind	Case=Acc|Numb=Plur|Gend=Masc
Numidas	Numidae	NOMpro	Case=Acc|Numb=Plur
etiam	etiam	ADV	Deg=Pos
equis	equus	NOMcom	Case=Abl|Numb=Plur
caesariatos	caesario	VER	Case=Acc|Numb=Plur|Gend=Masc
iuxta	iuxta2	PRE	MORPH=empty
cutem	cutis	NOMcom	Case=Acc|Numb=Sing
tonsor	tonsor	NOMcom	Case=Nom|Numb=Sing
et	et2	CONcoo	MORPH=empty
cultri	culter	NOMcom	Case=Gen|Numb=Sing
vertex	uertex	NOMcom	Case=Nom|Numb=Sing
solus	solus	PROind	Case=Nom|Numb=Sing|Gend=Masc
immunis	immunis	ADJqua	Case=Nom|Numb=Sing|Gend=MascFem|Deg=Pos
unde	unde1	ADVrel	MORPH=empty
apud	apud	PRE	MORPH=empty
hirtos	hirtus	NOMcom	Case=Acc|Numb=Plur|Deg=Pos
et	et2	CONcoo	MORPH=empty
hirsutos	hirsutus	ADJqua	Case=Acc|Numb=Plur|Gend=Masc|Deg=Pos
tam	tam	ADV	Deg=Pos
rapax	rapax	ADJqua	Case=Nom|Numb=Sing|Gend=Com|Deg=Pos
ab	ab	PRE	MORPH=empty
ala	ala	NOMcom	Case=Abl|Numb=Sing
resina	resina	NOMcom	Case=Nom|Numb=Sing
tam	tam	ADV	Deg=Pos
furax	furax	ADJqua	Case=Nom|Numb=Sing|Gend=Com|Deg=Pos
a	ab	PRE	MORPH=empty
mento	mentum	NOMcom	Case=Abl|Numb=Sing
volsella	uoluella	NOMpro	Case=Nom|Numb=Sing
Prodigium	prodigium	NOMcom	Case=Nom|Numb=Sing
est	sum1	VER	Numb=Sing|Mood=Ind|Tense=Pres|Voice=Act|Person=3
haec	hic1	PROdem	Case=Nom|Numb=Sing|Gend=Fem
sine	sine	PRE	MORPH=empty
pallio	pallium	NOMcom	Case=Abl|Numb=Sing
fieri	fio	VER	Mood=Inf|Tense=Pres|Voice=Act
Illius	ille	PROdem	Case=Gen|Numb=Sing|Gend=Com
est	sum1	VER	Numb=Sing|Mood=Ind|Tense=Pres|Voice=Act|Person=3
haec	hic1	PROdem	Case=Nom|Numb=Sing|Gend=Fem
tota	totus	PROind	Case=Nom|Numb=Sing|Gend=Fem
res	res	NOMcom	Case=Nom|Numb=Sing
Asiae	Asia	NOMpro	Case=Gen|Numb=Sing
Quid	quis1	PROint	Case=Acc|Numb=Sing|Gend=Neut
tibi	tu	PROper	Case=Dat|Numb=Sing
Libya	Libya	NOMpro	Case=Abl|Numb=Sing
et	et2	CONcoo	MORPH=empty
Europa	Europa	NOMpro	Case=Voc|Numb=Sing
cum	cum2	PRE	MORPH=empty
xysticis	xysticus	ADJqua	Case=Abl|Numb=Plur|Gend=Com
munditiis	munditia	NOMcom	Case=Abl|Numb=Plur
quas	qui1	PROrel	Case=Acc|Numb=Plur|Gend=Fem
vestire	uestio	VER	Mood=Inf|Tense=Pres|Voice=Act
non	non	ADVneg	MORPH=empty
nosti	nosco	VER	Numb=Sing|Mood=Ind|Tense=Perf|Voice=Act|Person=2
Revera	reuera	ADV	Deg=Pos|Person=2
enim	enim2	CONcoo	MORPH=empty
quale	qualis1	PROrel	Case=Nom|Numb=Sing|Gend=Neut
est	sum1	VER	Numb=Sing|Mood=Ind|Tense=Pres|Voice=Act|Person=3
Graecatim	Graecatis	ADV	Deg=Pos
depilari	depilo1	VER	Mood=Inf|Tense=Pres|Voice=Pass
magis	magis2	ADV	Deg=Comp
quam	quam1	ADVrel	MORPH=empty
amiciri	amicio	VER	Mood=Inf|Tense=Pres|Voice=Pass
Habitum	Habitus	NOMcom	Case=Acc|Numb=Sing
transferre	transfero	VER	Mood=Inf|Tense=Pres|Voice=Act
ita	ita	ADV	Deg=Pos
demum	demum	ADV	Deg=Pos
culpae	culpa	NOMcom	Case=Dat|Numb=Sing
prope	prope1	ADV	Deg=Pos
est	sum1	VER	Numb=Sing|Mood=Ind|Tense=Pres|Voice=Act|Person=3
si	si2	CONsub	MORPH=empty
non	non	ADVneg	MORPH=empty
consuetudo	consuetudo	NOMcom	Case=Nom|Numb=Sing
sed	sed	CONcoo	MORPH=empty
natura	natura	NOMcom	Case=Nom|Numb=Sing
mutetur	muto2	VER	Numb=Sing|Mood=Sub|Tense=Pres|Voice=Pass|Person=3
Sat	satis2	ADV	Case=Ind|Deg=Pos
refert	refero	VER	Numb=Sing|Mood=Ind|Tense=Pres|Voice=Act|Person=3
inter	inter	PRE	MORPH=empty
honorem	honor	NOMcom	Case=Acc|Numb=Sing
temporis	tempus1	NOMcom	Case=Gen|Numb=Sing
et	et2	CONcoo	MORPH=empty
religionem	religio	NOMcom	Case=Acc|Numb=Sing
Det	do	VER	Numb=Sing|Mood=Sub|Tense=Pres|Voice=Act|Person=3
consuetudo	consuetudo	NOMcom	Case=Nom|Numb=Sing
fidem	fides2	NOMcom	Case=Acc|Numb=Sing
tempori	tempus1	NOMcom	Case=Dat|Numb=Sing
natura	natura	NOMcom	Case=Nom|Numb=Sing
deo	deus	NOMcom	Case=Dat|Numb=Sing
Naturam	natura	NOMcom	Case=Acc|Numb=Sing
itaque	itaque	CONcoo	MORPH=empty
concussit	concutio	VER	Numb=Sing|Mood=Ind|Tense=Perf|Voice=Act|Person=3
Larissaeus	Larissaeus	ADJqua	Case=Nom|Numb=Sing|Gend=Masc|Deg=Pos
heros	heros	NOMcom	Case=Nom|Numb=Sing
in	in	PRE	MORPH=empty
virginem	uirgo	NOMcom	Case=Acc|Numb=Sing
mutando	muto2	VER	Case=Abl|Numb=Sing|Mood=Ger|Voice=Act
ille	ille	PROdem	Case=Nom|Numb=Sing|Gend=Masc
ferarum	fera	NOMcom	Case=Gen|Numb=Plur
medullis	medulla	NOMcom	Case=Abl|Numb=Plur
educatus	educo1	VER	Case=Nom|Numb=Sing|Gend=Masc|Mood=Par|Tense=Perf|Voice=Pass
unde	unde1	ADVrel	MORPH=empty
et	et1	ADV	Deg=Pos
nominis	nomen	NOMcom	Case=Gen|Numb=Sing
concilium	concilium	NOMcom	Case=Acc|Numb=Sing
quandoquidem	quandoquidem	CONsub	MORPH=empty
labiis	labium	NOMcom	Case=Dat|Numb=Plur
vacuerat	uaco	VER	Numb=Sing|Mood=Ind|Tense=Pqp|Voice=Act|Person=3
ab	ab	PRE	MORPH=empty
uberum	uber1	NOMcom	Case=Gen|Numb=Plur
gustu	gustus	NOMcom	Case=Abl|Numb=Sing
ille	ille	PROdem	Case=Nom|Numb=Sing|Gend=Masc
apud	apud	PRE	MORPH=empty
rupicem	rupex	NOMcom	Case=Acc|Numb=Sing
et	et2	CONcoo	MORPH=empty
silvicolam	siluicola	NOMcom	Case=Acc|Numb=Sing
et	et2	CONcoo	MORPH=empty
monstrum	monstrum	NOMcom	Case=Acc|Numb=Sing
eruditorem	eruditor	NOMcom	Case=Acc|Numb=Sing
scrupea	scrupeus	ADJqua	Case=Abl|Numb=Sing|Gend=Fem|Deg=Pos
schola	schola	NOMcom	Case=Abl|Numb=Sing
eruditus	erudio	VER	Case=Nom|Numb=Sing|Gend=Masc|Deg=Pos
Feras	fera	NOMcom	Case=Acc|Numb=Sing
si	si2	CONsub	MORPH=empty
in	in	PRE	MORPH=empty
puero	puer	NOMcom	Case=Abl|Numb=Sing
matris	mater	NOMcom	Case=Gen|Numb=Sing
sollicitudinem	sollicitudo	NOMcom	Case=Acc|Numb=Sing
patiens	patiens	ADJqua	Case=Nom|Numb=Sing|Gend=Com|Deg=Pos
certe	certe	ADV	Deg=Pos
iam	iam	ADV	Deg=Pos
histriculus	histriculus	NOMcom	Case=Nom|Numb=Sing
certe	certe	ADV	Deg=Pos
iam	iam	ADV	Deg=Pos
virum	uir	NOMcom	Case=Acc|Numb=Sing
alicui	aliquis	PROind	Case=Dat|Numb=Sing|Gend=Com
clanculo	clanculum	ADV	Case=Dat|Numb=Sing
functus	fungor	VER	Case=Nom|Numb=Sing|Gend=Masc|Mood=Par|Tense=Perf|Voice=Dep
adhuc	adhuc	ADV	Deg=Pos
sustinet	sustineo	VER	Numb=Sing|Mood=Ind|Tense=Pres|Voice=Act|Person=3
stolam	stola	NOMcom	Case=Acc|Numb=Sing
fundere	fundo2	VER	Mood=Inf|Tense=Pres|Voice=Act
comam	coma	NOMcom	Case=Acc|Numb=Sing
struere	struo	VER	Mood=Inf|Tense=Pres|Voice=Act
cutem	cutis	NOMcom	Case=Acc|Numb=Sing
fingere	fingo	VER	Mood=Inf|Tense=Pres|Voice=Act
speculum	speculum	NOMcom	Case=Acc|Numb=Sing
consulere	consulo	VER	Mood=Inf|Tense=Pres|Voice=Act
collum	collum	NOMcom	Case=Acc|Numb=Sing
demulcere	demulceo	VER	Mood=Inf|Tense=Pres|Voice=Act
aurem	auris	NOMcom	Case=Acc|Numb=Sing
quoque	quoque	ADV	Deg=Pos
feratu	feratus	NOMcom	Case=Abl|Numb=Sing
effeminatus	effemino	ADJqua	Case=Nom|Numb=Sing|Gend=Masc
quod	qui1	PROrel	Case=Acc|Numb=Sing|Gend=Neut
illi	ille	PROdem	Case=Dat|Numb=Sing|Gend=Com
apud	apud	PRE	MORPH=empty
Sigeum	Sigeum	NOMcom	Case=Acc|Numb=Sing
strongyla	strongylus	NOMcom	Case=Nom|Numb=Sing
servat	seruo	VER	Numb=Sing|Mood=Ind|Tense=Pres|Voice=Act|Person=3
Plane	plane	ADV	Deg=Pos
postea	postea	ADV	Deg=Pos
miles	miles	NOMcom	Case=Nom|Numb=Sing
est	sum1	VER	Numb=Sing|Mood=Ind|Tense=Pres|Voice=Act|Person=3
necessitas	necessitas	NOMcom	Case=Nom|Numb=Sing
enim	enim2	CONcoo	MORPH=empty
reddidit	reddo	VER	Numb=Sing|Mood=Ind|Tense=Perf|Voice=Act|Person=3
sexum	sexus	NOMcom	Case=Acc|Numb=Sing
De	de	PRE	MORPH=empty
praelio	proelium	NOMcom	Case=Abl|Numb=Sing
sonuerat	sono1	VER	Numb=Sing|Mood=Ind|Tense=Pqp|Voice=Act|Person=3
nec	nec2	CONcoo	MORPH=empty
arma	arma	NOMcom	Case=Acc|Numb=Plur
longe	longe	ADV	Deg=Pos
Ipsum	ipse	PROdem	Case=Acc|Numb=Sing|Gend=MascNeut
inquit	inquio	VER	Numb=Sing|Mood=Ind|Tense=Pres|Voice=Act|Person=3
ferrum	ferrum	NOMcom	Case=Acc|Numb=Sing
virum	uir	NOMcom	Case=Acc|Numb=Sing
attrahit	attraho	VER	Numb=Sing|Mood=Ind|Tense=Pres|Voice=Act|Person=3
Ceterum	ceterum2	ADV	Deg=Pos
si	si2	CONsub	MORPH=empty
post	post2	PRE	Deg=Pos
incentivum	incentiuus	NOMcom	Case=Acc|Numb=Sing|Gend=MascNeut|Deg=Pos
quoque	quoque	ADV	Deg=Pos
puellam	puella	NOMcom	Case=Acc|Numb=Sing
perseverasset	perseuero	VER	Numb=Sing|Mood=Sub|Tense=Pqp|Voice=Act|Person=3
potuit	possum1	VER	Numb=Sing|Mood=Ind|Tense=Perf|Voice=Act|Person=3
et	et2	CONcoo	MORPH=empty
nubere	nubo	VER	Mood=Inf|Tense=Pres|Voice=Act
Ecce	ecce	INJ	MORPH=empty
itaque	itaque	CONcoo	MORPH=empty
mutatio	mutatio	NOMcom	Case=Nom|Numb=Sing
Monstrum	monstrum	NOMcom	Case=Nom|Numb=Sing
equidem	equidem	ADV	Deg=Pos
geminum	geminus	ADJqua	Case=Nom|Numb=Sing|Gend=MascNeut|Deg=Pos
de	de	PRE	MORPH=empty
viro	uir	NOMcom	Case=Abl|Numb=Sing
femina	femina	NOMcom	Case=Nom|Numb=Sing
mox	mox	ADV	Deg=Pos
de	de	PRE	MORPH=empty
femina	femina	NOMcom	Case=Abl|Numb=Sing
vir	uir	NOMcom	Case=Nom|Numb=Sing
quando	quando3	CONsub	MORPH=empty
neque	neque	CONcoo	MORPH=empty
veritas	ueritas	NOMcom	Case=Nom|Numb=Sing
negari	nego	VER	Mood=Inf|Tense=Pres|Voice=Pass
debusset	debeo	VER	Numb=Sing|Mood=Sub|Tense=Pqp|Voice=Act|Person=3
neque	neque	CONcoo	MORPH=empty
fallacia	fallax	NOMcom	Case=Abl|Numb=Sing
confiteri	confiteor	VER	Mood=Inf|Tense=Pres|Voice=Dep
Uterque	uterque	PROind	Case=Nom|Numb=Sing|Gend=Masc
habitus	habitus1	NOMcom	Case=Gen|Numb=Sing
mutandi	muto2	VER	Case=Gen|Numb=Sing|Mood=Ger|Voice=Act
malus	malus3	ADJqua	Case=Nom|Numb=Sing|Gend=Masc|Deg=Pos
alter	alter	PROind	Case=Nom|Numb=Sing|Gend=Masc
adversus	aduersus3	PRE	MORPH=empty
naturam	natura	NOMcom	Case=Acc|Numb=Sing
alter	alter	PROind	Case=Nom|Numb=Sing|Gend=Masc
contra	contra2	PRE	MORPH=empty
salutem	salus	NOMcom	Case=Acc|Numb=Sing
Turpius	turpiter	ADJqua	Case=Nom|Numb=Sing|Deg=Comp
adhuc	adhuc	ADV	Deg=Pos
libido	libido	NOMcom	Case=Nom|Numb=Sing
virum	uir	NOMcom	Case=Acc|Numb=Sing
cultu	cultus1	NOMcom	Case=Abl|Numb=Sing
transfiguravit	transfiguro	VER	Numb=Sing|Mood=Ind|Tense=Perf|Voice=Act|Person=3
quam	quam1	ADVrel	MORPH=empty
aliqua	aliquis	PROind	Case=Nom|Numb=Sing|Gend=Fem
materna	maternus	ADJqua	Case=Nom|Numb=Sing|Gend=Fem|Deg=Pos
formido	formido1	NOMcom	Case=Nom|Numb=Sing
tametsi	tametsi2	CONsub	MORPH=empty
adoratur	adoro	VER	Numb=Sing|Mood=Ind|Tense=Pres|Voice=Pass|Person=3
a	ab	PRE	MORPH=empty
vobis	uos	PROper	Case=Abl|Numb=Plur
qui	qui1	PROrel	Case=Nom|Numb=Sing|Gend=Masc
erubescendus	erubesco	VER	Case=Nom|Numb=Sing|Gend=Masc|Mood=Adj|Voice=Pass
est	sum1	VER	Numb=Sing|Mood=Ind|Tense=Pres|Voice=Act|Person=3
scytalosagittipelliger	scytalosagiger	NOMcom	Numb=Sing|Deg=Pos
ille	ille	PROdem	Case=Nom|Numb=Sing|Gend=Masc
qui	qui1	PROrel	Case=Nom|Numb=Sing|Gend=Masc
totam	totus	PROind	Case=Acc|Numb=Sing|Gend=Fem
epitheti	epithetus	NOMcom	Case=Gen|Numb=Sing
sui	suus	PROpos.ref	Case=Gen|Numb=Sing|Gend=MascNeut
sortem	sors	NOMcom	Case=Acc|Numb=Sing
cum	cum2	PRE	MORPH=empty
muliebri	muliebris	ADJqua	Case=Abl|Numb=Sing|Gend=Com|Deg=Pos
cultu	cultus1	NOMcom	Case=Abl|Numb=Sing
compensavit	compenso	VER	Numb=Sing|Mood=Ind|Tense=Perf|Voice=Act|Person=3
Tantum	tantum1	PROdem	Numb=Sing|Deg=Pos
Lydiae	Lydia	NOMpro	Case=Gen|Numb=Sing
clanculariae	clancularia	NOMcom	Case=Gen|Numb=Sing
licuit	licet1	VER	Numb=Sing|Mood=Ind|Tense=Perf|Voice=Act|Person=3
ut	ut4	CONsub	MORPH=empty
Hercules	Hercules	NOMpro	Case=Nom|Numb=Sing
in	in	PRE	MORPH=empty
Omphale	Omphale	NOMpro	Case=Acc|Numb=Sing
et	et2	CONcoo	MORPH=empty
Omphale	Omphale	NOMpro	Case=Abl|Numb=Sing
in	in	PRE	MORPH=empty
Hercule	Hercules	NOMpro	Case=Abl|Numb=Sing
prostitueretur	prostituo	VER	Numb=Sing|Mood=Sub|Tense=Impa|Voice=Pass|Person=3
Ubi	ubi1	ADVrel	MORPH=empty
Diomedes	Diomedes	NOMpro	Case=Nom|Numb=Sing
et	et2	CONcoo	MORPH=empty
cruenta	cruentus	ADJqua	Case=Nom|Numb=Plur|Gend=Neut|Deg=Pos
praesepia	praesaepe	NOMcom	Case=Nom|Numb=Plur
ubi	ubi1	ADVrel	MORPH=empty
Busiris	Busiris	NOMpro	Case=Nom|Numb=Sing
et	et2	CONcoo	MORPH=empty
bustruaria	bustruaria	ADJqua	Case=Nom|Numb=Plur|Gend=Neut|Deg=Pos
altaria	altar	NOMcom	Case=Acc|Numb=Plur
ubi	ubi1	ADVrel	MORPH=empty
Geryon	Geryon	NOMpro	Case=Nom|Numb=Sing
ter	ter	ADJadv.mul	MORPH=empty
unus	unus	ADJcar	Case=Nom|Numb=Sing|Gend=Masc
Cerebris	cerebrum	NOMpro	Case=Nom|Numb=Plur
adhuc	adhuc	ADV	Deg=Pos
eorum	is	PROdem	Case=Gen|Numb=Plur|Gend=MascNeut
clava	claua	NOMcom	Case=Abl|Numb=Sing
foetere	foetus	ADV	MORPH=empty
malebat	malo	VER	Numb=Sing|Mood=Ind|Tense=Impa|Voice=Act|Person=3
cum	cum3	CONsub	MORPH=empty
unguentis	unguentum	NOMcom	Case=Abl|Numb=Plur
offenderetur	offendo	VER	Numb=Sing|Mood=Sub|Tense=Impa|Voice=Pass|Person=3
Vetus	uetus	ADJqua	Case=Nom|Numb=Sing|Gend=Com|Deg=Pos
iam	iam	ADV	Deg=Pos
Hydrae	Hydra	NOMpro	Case=Gen|Numb=Sing
Centaurorumque	Centaurus	NOMpro	Case=Gen|Numb=Plur
{Centaurorumque}	que	CON	MORPH=empty
sanguis	sanguis	NOMcom	Case=Nom|Numb=Sing
in	in	PRE	MORPH=empty
sagittis	sagitta	NOMcom	Case=Abl|Numb=Plur
pumice	pumex	NOMcom	Case=Abl|Numb=Sing
spiculi	spiculum	NOMcom	Case=Gen|Numb=Sing
excludebatur	excludo	VER	Numb=Sing|Mood=Ind|Tense=Impa|Voice=Pass|Person=3
insultante	insulto	VER	Case=Abl|Numb=Sing|Gend=Com|Mood=Par|Tense=Pres|Voice=Act
luxuria	luxuria	NOMcom	Case=Abl|Numb=Sing
ut	ut4	CONsub	MORPH=empty
post	post2	PRE	MORPH=empty
monstra	monstrum	NOMcom	Case=Acc|Numb=Plur
transfixa	transfigo	VER	Case=Acc|Numb=Plur|Gend=Neut|Mood=Par|Tense=Perf|Voice=Pass
coronam	corona	NOMcom	Case=Acc|Numb=Sing
forsitan	forsitan	ADV	Deg=Pos
suerent	suesco	VER	Numb=Plur|Mood=Sub|Tense=Impa|Voice=Act|Person=3
Ne	ne3	ADVneg	MORPH=empty
sobriae	sobrius	ADJqua	Case=Gen|Numb=Sing|Gend=Fem|Deg=Pos
mulieris	mulier	NOMcom	Case=Gen|Numb=Sing
quidem	quidem	ADV	Deg=Pos
aut	aut	CONcoo	MORPH=empty
viraginis	uirago	NOMcom	Case=Gen|Numb=Sing
alicuius	aliquis	PROind	Case=Gen|Numb=Sing|Gend=Com
scapulae	scapula	NOMcom	Case=Nom|Numb=Plur
sub	sub	PRE	MORPH=empty
exuvias	exuuiae	NOMcom	Case=Acc|Numb=Plur
bestiae	bestia	NOMcom	Case=Nom|Numb=Plur
tantae	tantus	PROdem	Case=Gen|Numb=Plur|Gend=Fem
introire	introeo1	VER	Mood=Inf|Tense=Pres|Voice=Act
potuissent	possum1	VER	Numb=Plur|Mood=Sub|Tense=Pqp|Voice=Act|Person=3
nisi	nisi	CONsub	MORPH=empty
diu	diu	ADV	Deg=Pos
mollitas	mollio	NOMcom	Case=Nom|Numb=Sing
et	et2	CONcoo	MORPH=empty
evigoratas	euigoratus	VER	Case=Acc|Numb=Plur|Gend=Fem|Mood=Par|Tense=Perf|Voice=Pass
et	et2	CONcoo	MORPH=empty
exodoratas	exodoro	VER	Case=Acc|Numb=Plur|Gend=Fem|Mood=Par|Tense=Perf|Voice=Pass
quod	qui1	PROrel	Case=Acc|Numb=Sing|Gend=Neut
apud	apud	PRE	MORPH=empty
Omphalen	Omphales	NOMpro	Case=Acc|Numb=Sing
balsamo	balsamum	NOMcom	Case=Abl|Numb=Sing
aut	aut	CONcoo	MORPH=empty
telino	telinum	NOMcom	Case=Abl|Numb=Sing
spero	spero	VER	Numb=Sing|Mood=Ind|Tense=Pres|Voice=Act
factum	facio	VER	Case=Acc|Numb=Sing|Gend=MascNeut|Mood=Par|Tense=Perf|Voice=Pass
credo	credo	VER	Numb=Sing|Mood=Ind|Tense=Pres|Voice=Act|Person=1
et	et2	CONcoo	MORPH=empty
iubas	iuba	NOMcom	Case=Acc|Numb=Plur
pectinem	pecten	NOMcom	Case=Acc|Numb=Sing
passas	pando2	VER	Case=Acc|Numb=Plur|Gend=Fem|Mood=Par|Tense=Perf|Voice=Dep
ne	ne4	CONsub	MORPH=empty
cervicem	ceruix	NOMcom	Case=Acc|Numb=Sing
enervem	eneruis	ADJqua	Case=Acc|Numb=Sing|Gend=MascFem|Deg=Pos
inureret	inuro	VER	Numb=Sing|Mood=Sub|Tense=Impa|Voice=Act|Person=3
sciria	sciria	NOMcom	Case=Abl|Numb=Plur
leonina	leonina	NOMcom	Case=Abl|Numb=Sing|Deg=Pos
Hiatus	hiatus	VER	Case=Nom|Numb=Sing
crinibus	crinis	NOMcom	Case=Abl|Numb=Plur
infarsus	infarsus	ADJqua	Case=Nom|Numb=Sing|Gend=Masc|Deg=Pos
genuini	genuinus	ADJqua	Case=Gen|Numb=Sing|Gend=MascNeut
inter	inter	PRE	MORPH=empty
antias	antia	NOMcom	Case=Acc|Numb=Plur
adumbrati	adumbratus	ADJqua	Case=Gen|Numb=Sing|Gend=MascNeut
tota	totus	PROind	Case=Abl|Numb=Sing|Gend=Fem
oris	os?	NOMcom	Case=Gen|Numb=Sing
contumelia	contumelia	NOMcom	Case=Abl|Numb=Sing
mugiret	mugio	VER	Numb=Sing|Mood=Sub|Tense=Impa|Voice=Act|Person=3
si	si2	CONsub	MORPH=empty
posset	possum1	VER	Numb=Sing|Mood=Sub|Tense=Impa|Voice=Act|Person=3
Nemaea	Nemaeus	ADJqua	Case=Nom|Numb=Sing|Gend=Fem
certe	certe	ADV	Deg=Pos
si	si2	CONsub	MORPH=empty
quis	quis2	PROind	Case=Nom|Numb=Sing|Gend=MascFem
loci	locus	NOMcom	Case=Gen|Numb=Sing
genius	genius	NOMcom	Case=Nom|Numb=Sing
ingemebat	ingemo	VER	Numb=Sing|Mood=Ind|Tense=Impa|Voice=Act|Person=3
tunc	tunc	ADV	Deg=Pos
enim	enim2	CONcoo	MORPH=empty
se	sui1	PROref	Case=Acc|Numb=Sing
circumspexit	circumspicio	VER	Numb=Sing|Mood=Ind|Tense=Perf|Voice=Act|Person=3
leonem	leo	NOMcom	Case=Acc|Numb=Sing
perdidisse	perdo	VER	Mood=Inf|Tense=Perf|Voice=Act
Qualis	qualis1	PROrel	Case=Nom|Numb=Sing|Gend=MascFem
ille	ille	PROdem	Case=Nom|Numb=Sing|Gend=Masc
Hercules	Hercules	NOMpro	Case=Nom|Numb=Sing
in	in	PRE	MORPH=empty
serico	sericum	ADJqua	Case=Abl|Numb=Sing
Omphales	Omphales	NOMpro	Case=Nom|Numb=Sing
fuerit	sum1	VER	Numb=Sing|Mood=Sub|Tense=Perf|Voice=Act|Person=3
iam	iam	ADV	Deg=Pos
Omphale	Omphale	NOMpro	Case=Acc|Numb=Sing
in	in	PRE	MORPH=empty
Herculis	Hercules	NOMpro	Case=Gen|Numb=Sing
scorto	scortum	NOMcom	Case=Abl|Numb=Sing
designata	designo	VER	Case=Acc|Numb=Sing|Gend=Neut|Mood=Par|Tense=Perf|Voice=Pass
descripsit	describo	VER	Numb=Sing|Mood=Ind|Tense=Perf|Voice=Act|Person=3
Sed	sed	CONcoo	MORPH=empty
et	et1	ADV	Deg=Pos
qui	qui1	PROrel	Case=Nom|Numb=Sing|Gend=Masc
ante	ante2	PRE	MORPH=empty
Tyrinthium	Tyrinthius	NOMpro	Case=Acc|Numb=Sing
accesserat	accedo1	VER	Numb=Sing|Mood=Ind|Tense=Pqp|Voice=Act|Person=3
pugil	pugil	NOMcom	Case=Nom|Numb=Sing
Cleomachus	Cleomachus	NOMpro	Case=Nom|Numb=Sing
post	post1	ADV	Deg=Pos
Olympiae	Olympia	NOMpro	Case=Gen|Numb=Sing
cum	cum3	CONsub	MORPH=empty
incredibile	incredibilis	ADJqua	Case=Acc|Numb=Sing|Gend=Neut|Deg=Pos
mutatu	muto2	VER	Case=Abl|Numb=Sing|Mood=SupUm|Voice=Act
de	de	PRE	MORPH=empty
masculo	masculus	NOMcom	Case=Abl|Numb=Sing|Deg=Pos
fluxisset	fluo	VER	Numb=Sing|Mood=Sub|Tense=Pqp|Voice=Act|Person=3
intra	intra2	PRE	MORPH=empty
cutem	cutis	NOMcom	Case=Acc|Numb=Sing
caesus	caedo	VER	Case=Nom|Numb=Sing|Gend=Masc|Mood=Par|Tense=Perf|Voice=Pass
et	et2	CONcoo	MORPH=empty
ultra	ultra1	ADV	Deg=Pos
inter	inter	PRE	MORPH=empty
Fullones	Fullo	NOMpro	Case=Acc|Numb=Plur
iam	iam	ADV	Deg=Pos
Novianos	Nouianus	NOMpro	Case=Acc|Numb=Plur
coronandus	corono	VER	Case=Nom|Numb=Sing|Gend=Masc|Mood=Adj|Voice=Pass
meritoque	merito	ADV	Gend=MascNeut|Deg=Pos
{meritoque}	que	CON	MORPH=empty
mimographo	mimographus	NOMcom	Case=Abl|Numb=Sing
Lentulo	Lentulus	NOMpro	Case=Abl|Numb=Sing
in	in	PRE	MORPH=empty
Catinensibus	Catinenses	NOMpro	Case=Abl|Numb=Plur
commemoratus	commemoro	VER	Case=Nom|Numb=Sing|Gend=Masc|Mood=Par|Tense=Perf|Voice=Pass
utique	utique	ADV	Deg=Pos
sicut	sicut1	ADVrel	MORPH=empty
vestigia	uestigium	NOMcom	Case=Acc|Numb=Plur
cestuum	cestus	NOMcom	Case=Gen|Numb=Plur
viriis	uisia	NOMcom	Case=Dat|Numb=Plur
occupavit	occupo2	VER	Numb=Sing|Mood=Ind|Tense=Perf|Voice=Act|Person=3
ita	ita	ADV	Deg=Pos
et	et2	CONcoo	Deg=Pos
endromidis	endromis	NOMcom	Case=Gen|Numb=Plur
solocem	solox	NOMcom	Case=Acc|Numb=Sing
aliqua	aliquis	PROind	Case=Acc|Numb=Plur|Gend=Neut
multicia	multicia	NOMcom	Case=Acc|Numb=Plur
synthesi	synthesis	NOMcom	Case=Gen|Numb=Sing
extrusit	extrudo	VER	Numb=Sing|Mood=Ind|Tense=Perf|Voice=Act|Person=3
Physconem	Physcon	NOMpro	Case=Acc|Numb=Sing
et	et2	CONcoo	MORPH=empty
Sardanapalum	Sardanapalus	NOMpro	Case=Acc|Numb=Sing
tacendum	taceo	VER	Case=Nom|Numb=Sing|Gend=Neut|Mood=Adj|Voice=Pass
est	sum1	VER	Numb=Sing|Mood=Ind|Tense=Pres|Voice=Act|Person=3
qui	qui1	PROrel	Case=Nom|Numb=Sing|Gend=Masc
nisi	nisi	CONsub	MORPH=empty
insignes	insignis	ADJqua	Case=Acc|Numb=Plur|Gend=MascFem|Deg=Pos
libidinum	libido	NOMcom	Case=Gen|Numb=Plur
alias	alius	PROind	Case=Acc|Numb=Plur|Gend=Fem
reges	rex	NOMcom	Case=Acc|Numb=Plur
nemo	nemo	PROind	Case=Nom|Numb=Sing
nosset	nosco	VER	Numb=Sing|Mood=Sub|Tense=Pqp|Voice=Act|Person=3
Tacendum	taceo	VER	Case=Acc|Numb=Sing|Gend=MascNeut|Mood=Adj|Voice=Pass
autem	autem	CONcoo	MORPH=empty
ne	ne4	CONsub	MORPH=empty
quid	quis2	PROind	Case=Acc|Numb=Sing|Gend=Neut
et	et2	CONcoo	Deg=Pos
illi	ille	PROdem	Case=Nom|Numb=Sing|Gend=Masc
de	de	PRE	MORPH=empty
Caesaribus	Caesar	NOMpro	Case=Abl|Numb=Plur
quibusdam	quidam	PROind	Case=Abl|Numb=Plur|Gend=Com
vestris	uester	PROpos	Case=Abl|Numb=Plur|Gend=Com
obmussitent	obmussito	VER	Numb=Plur|Mood=Sub|Tense=Pres|Voice=Act|Person=3
pariter	pariter	ADV	Deg=Pos
propudiosis	propudiosus	ADJqua	Case=Abl|Numb=Plur|Gend=Com|Deg=Pos
ne	ne4	CONsub	MORPH=empty
caninae	caninus	ADJqua	Case=Gen|Numb=Sing|Gend=Fem|Deg=Pos
forte	forte	ADV	Deg=Pos
constantiae	constantia	NOMcom	Case=Gen|Numb=Sing
mandatum	mandatum	NOMcom	Case=Nom|Numb=Sing
sit	sum1	VER	Numb=Sing|Mood=Sub|Tense=Pres|Voice=Act|Person=3
impuriorem	impurus	ADJqua	Case=Acc|Numb=Sing|Gend=MascFem|Deg=Comp
Physcone	Physcon	NOMpro	Case=Dat|Numb=Sing
et	et2	CONcoo	MORPH=empty
molliorem	mollis	ADJqua	Case=Acc|Numb=Sing|Gend=MascFem|Deg=Comp
Sardanapalo	Sardanapalus	NOMpro	Case=Dat|Numb=Sing
Caesarem	Caesar	NOMpro	Case=Acc|Numb=Sing
designare	designo	VER	Mood=Inf|Tense=Pres|Voice=Act
et	et2	CONcoo	MORPH=empty
quidem	quidem	ADV	Deg=Pos
Subneronem	subnero	NOMpro	Case=Acc|Numb=Sing
Nectepidior	nectepidus	ADJqua	Case=Nom|Numb=Sing|Gend=MascFem|Deg=Comp
vis	uis	NOMcom	Case=Nom|Numb=Sing
vanae	uanus	ADJqua	Case=Dat|Numb=Sing|Gend=Fem|Deg=Pos
quoque	quoque	ADV	Deg=Pos
gloriae	gloria	NOMcom	Case=Gen|Numb=Sing
mutandis	muto2	VER	Case=Dat|Numb=Plur|Gend=Com|Mood=Adj|Voice=Pass
induviis	induuiae	NOMcom	Case=Dat|Numb=Plur
etiam	etiam	ADV	Deg=Pos
viro	uir	NOMcom	Case=Dat|Numb=Sing
salvo	saluus	ADJqua	Case=Dat|Numb=Sing|Gend=MascNeut|Deg=Pos
Calor	calor	NOMcom	Case=Nom|Numb=Sing
est	sum1	VER	Numb=Sing|Mood=Ind|Tense=Pres|Voice=Act|Person=3
omnis	omnis	PROind	Case=Nom|Numb=Sing|Gend=MascFem
affectus	affectus1	NOMcom	Case=Nom|Numb=Sing
verum	uerum4	CONcoo	MORPH=empty
cum	cum3	CONsub	MORPH=empty
in	in	PRE	MORPH=empty
affectationem	affectatio	NOMcom	Case=Acc|Numb=Sing
flabellatur	flabello	VER	Numb=Sing|Mood=Ind|Tense=Pres|Voice=Pass|Person=3
iam	iam	ADV	Deg=Pos
de	de	PRE	MORPH=empty
incendio	incendium	NOMcom	Case=Abl|Numb=Sing
gloriae	gloria	NOMcom	Case=Gen|Numb=Sing
ardor	ardor	NOMcom	Case=Nom|Numb=Sing
est	sum1	VER	Numb=Sing|Mood=Ind|Tense=Pres|Voice=Act|Person=3
Habes	habeo	VER	Numb=Sing|Mood=Ind|Tense=Pres|Voice=Act|Person=2
igitur	igitur	CONcoo	MORPH=empty
ex	ex	PRE	MORPH=empty
isto	iste	PROdem	Case=Abl|Numb=Sing|Gend=MascNeut
fomite	fomitis	NOMcom	Case=Abl|Numb=Sing
aestuantem	aestuo	VER	Case=Acc|Numb=Sing|Gend=MascFem|Mood=Par|Tense=Pres|Voice=Act
magnum	magnus	ADJqua	Case=Acc|Numb=Sing|Gend=MascNeut|Deg=Pos
regem	rex	NOMcom	Case=Acc|Numb=Sing
sola	solus	PROind	Case=Abl|Numb=Sing|Gend=Fem
gloria	gloria	NOMcom	Case=Abl|Numb=Sing
minorem	paruus2	ADJqua	Case=Acc|Numb=Sing|Gend=MascFem|Deg=Comp
Vicerat	uinco	VER	Numb=Sing|Mood=Ind|Tense=Pqp|Voice=Act|Person=3
Medicam	medicus2	ADJqua	Case=Acc|Numb=Sing|Gend=Fem|Deg=Pos
gentem	gens	NOMcom	Case=Acc|Numb=Sing
et	et2	CONcoo	MORPH=empty
victus	uictus	NOMcom	Case=Nom|Numb=Sing|Gend=Masc|Mood=Par|Tense=Perf|Voice=Pass
est	sum1	VER	Numb=Sing|Mood=Ind|Tense=Pres|Voice=Act|Person=3
Medica	medica?	ADJqua	Case=Abl|Numb=Sing|Deg=Pos
veste	uestis	NOMcom	Case=Abl|Numb=Sing
Triumphalem	triumphalis2	ADJqua	Case=Acc|Numb=Sing|Gend=MascFem|Deg=Pos
cataphracten	cataphractes	NOMcom	Case=Acc|Numb=Sing
amolitus	amolior	VER	Case=Nom|Numb=Sing|Gend=Masc|Mood=Par|Tense=Perf|Voice=Dep
in	in	PRE	MORPH=empty
captiva	captiuus1	NOMcom	Case=Abl|Numb=Sing|Gend=Neut|Deg=Pos
sarabara	sarabo	ADJqua	Case=Abl|Numb=Sing
decessit	decedo1	VER	Numb=Sing|Mood=Ind|Tense=Perf|Voice=Act|Person=3
pectus	pectus	NOMcom	Case=Acc|Numb=Sing
squamarum	squama	NOMcom	Case=Gen|Numb=Plur
signaculis	signaculum	NOMcom	Case=Abl|Numb=Plur
disculptum	disculpo	VER	Case=Acc|Numb=Sing|Gend=MascNeut|Mood=Par|Tense=Perf|Voice=Pass
textu	textus	NOMcom	Case=Abl|Numb=Sing
pellucido	pellucidus	ADJqua	Case=Abl|Numb=Sing
tegendo	tego	VER	Case=Abl|Numb=Sing|Gend=MascNeut|Mood=Ger|Voice=Act
nudavit	nudo	VER	Numb=Sing|Mood=Ind|Tense=Perf|Voice=Act|Person=3
anhelum	anhelus	ADJqua	Case=Acc|Numb=Sing|Gend=MascNeut
adhuc	adhuc	ADV	Deg=Pos
ab	ab	PRE	MORPH=empty
opere	opus1	NOMcom	Case=Abl|Numb=Sing
belli	bellum	NOMcom	Case=Gen|Numb=Sing
et	et2	CONcoo	MORPH=empty
ut	ut4	CONsub	MORPH=empty
mollius	molliter	ADV	Deg=Comp
ventilante	uentilo	VER	Case=Abl|Numb=Sing|Gend=Com|Deg=Pos|Mood=Par|Tense=Pres|Voice=Act
serico	sericum	NOMcom	Case=Abl|Numb=Sing
extinxit	exstinguo	VER	Numb=Sing|Mood=Ind|Tense=Perf|Voice=Act|Person=3
Non	non	ADVneg	MORPH=empty
erat	sum1	VER	Numb=Sing|Mood=Ind|Tense=Impa|Voice=Act|Person=3
satis	satis1	ADJqua	Case=Ind|Deg=Pos
animi	animus	NOMcom	Case=Gen|Numb=Sing
tumens	tumeo	VER	Case=Nom|Numb=Sing|Gend=Com|Mood=Par|Tense=Pres|Voice=Act
Macedo	Macedo	ADJqua	Case=Nom|Numb=Sing|Gend=Com|Deg=Pos
ni	ni2	CONsub	MORPH=empty
illum	ille	PROdem	Case=Acc|Numb=Sing|Gend=Masc
etiam	etiam	ADV	Deg=Pos
vestis	uestis	NOMcom	Case=Nom|Numb=Sing
inflatior	inflatus2	ADJqua	Case=Nom|Numb=Sing|Gend=MascFem|Deg=Comp
delectasset	delecto	VER	Numb=Sing|Mood=Sub|Tense=Pqp|Voice=Act|Person=3
nisi	nisi	CONsub	MORPH=empty
quod	qui1	CONsub	Gend=Neut
et	et2	CONcoo	MORPH=empty
philosophi	philosophus1	NOMcom	Case=Gen|Numb=Plur
puto	puto	VER	Numb=Sing|Mood=Ind|Tense=Pres|Voice=Act|Person=1
ipsi	ipse	PROdem	Case=Nom|Numb=Plur|Gend=Masc
aliquid	aliquis	PROind	Case=Acc|Numb=Sing|Gend=Neut
eiusmodi	eiusmodi	ADV	Deg=Pos
affectant	affecto	VER	Numb=Plur|Mood=Ind|Tense=Pres|Voice=Act|Person=3
Audio	audio	VER	Numb=Sing|Mood=Ind|Tense=Pres|Voice=Act|Person=1
enim	enim2	CONcoo	MORPH=empty
et	et2	CONcoo	MORPH=empty
in	in	PRE	MORPH=empty
purpura	purpura	NOMcom	Case=Abl|Numb=Sing
philosophatum	philosophor	VER	Case=Acc|Numb=Sing|Gend=MascNeut|Mood=Par|Tense=Perf|Voice=Dep
Si	si2	CONsub	MORPH=empty
philosophus	philosophus1	NOMcom	Case=Nom|Numb=Sing
in	in	PRE	MORPH=empty
purpura	purpura	NOMcom	Case=Abl|Numb=Sing
cur	cur	ADVint	MORPH=empty
non	non	ADVneg	MORPH=empty
et	et1	ADV	Deg=Pos
in	in	PRE	MORPH=empty
baxa	baxus	NOMcom	Case=Acc|Numb=Sing
Tyrium	Tyrius	ADJqua	Case=Acc|Numb=Sing|Gend=MascNeut
calciari	calceo	VER	MORPH=empty
nisi	nisi	CONsub	MORPH=empty
auro	aurum	NOMcom	Case=Abl|Numb=Sing
minime	parum2	ADV	Deg=Sup
Graecatur	graecor	VER	Numb=Sing|Mood=Ind|Tense=Pres|Voice=Dep|Person=3
Dicet	dico2	VER	Numb=Sing|Mood=Ind|Tense=Fut|Voice=Act|Person=3
Atquin	atqui	CONcoo	MORPH=empty
alius	alius	PROind	Case=Nom|Numb=Sing|Gend=Masc
et	et2	CONcoo	MORPH=empty
sericatus	serico	ADJqua	Case=Nom|Numb=Sing|Gend=Masc
et	et2	CONcoo	MORPH=empty
crepidam	crepida	ADJqua	Case=Acc|Numb=Sing
aeratus	aeratus	ADJqua	Case=Nom|Numb=Sing|Gend=Masc
incessit	incedo1	VER	Numb=Sing|Mood=Ind|Tense=Perf|Voice=Act|Person=3
Digne	digne	ADV	Case=Nom|Deg=Pos
quidem	quidem	ADV	Deg=Pos
ut	ut4	CONsub	MORPH=empty
bacchantibus	bacchor	VER	Case=Abl|Numb=Plur|Gend=Com|Mood=Par|Tense=Pres|Voice=Dep
indumentis	indumentum	VER	Case=Abl|Numb=Plur
aliquid	aliquis	PROind	Case=Acc|Numb=Sing|Gend=Neut
subtinniret	subtinno	VER	Numb=Sing|Mood=Sub|Tense=Impa|Voice=Act|Person=3
cymbalo	cymbalum	NOMcom	Case=Abl|Numb=Sing
incessit	incedo1	VER	Numb=Sing|Mood=Ind|Tense=Perf|Voice=Act|Person=3
Quod	quod1	CONcoo	MORPH=empty
si	si2	CONsub	MORPH=empty
iam	iam	ADV	Deg=Pos
tunc	tunc	ADV	Deg=Pos
locorum	locus	NOMcom	Case=Gen|Numb=Plur
Diogenes	Diogenes	NOMpro	Case=Nom|Numb=Sing
de	de	PRE	MORPH=empty
dolio	dolium	NOMcom	Case=Abl|Numb=Sing
latraret	latro2	VER	Numb=Sing|Mood=Sub|Tense=Impa|Voice=Act|Person=3
non	non	ADVneg	MORPH=empty
coenulentis	coenulentus	VER	Case=Abl|Numb=Plur|Gend=Com|Deg=Pos
pedibus	pes	NOMcom	Case=Abl|Numb=Plur
ut	ut1	ADVrel	MORPH=empty
tori	torus	NOMcom	Case=Nom|Numb=Plur
Platonici	Platonici	ADJqua	Case=Nom|Numb=Plur
sciunt	scio	VER	Numb=Plur|Mood=Ind|Tense=Pres|Voice=Act|Person=3
sed	sed	CONcoo	MORPH=empty
omnino	omnino	ADV	Deg=Pos
totum	totus	PROind	Case=Acc|Numb=Sing|Gend=MascNeut
Empedoclem	Empedocles	NOMpro	Case=Acc|Numb=Sing
in	in	PRE	MORPH=empty
adyta	adytum	NOMcom	Case=Acc|Numb=Sing
Cloacinarum	Cloacina	NOMpro	Case=Gen|Numb=Plur
detulisset	defero	VER	Numb=Sing|Mood=Sub|Tense=Pqp|Voice=Act|Person=3
ut	ut1	ADVrel	MORPH=empty
qui	qui1	PROrel	Case=Nom|Numb=Sing|Gend=Masc
se	sui1	PROref	Case=Acc|Numb=Sing
caelitem	caeles1	NOMcom	Case=Acc|Numb=Sing
delirarat	deliro	VER	Numb=Sing|Mood=Ind|Tense=Pqp|Voice=Act|Person=3
sorores	soror	NOMcom	Case=Acc|Numb=Plur
prius	prius	ADJadv.ord	Deg=Comp
suas	suus	PROpos.ref	Case=Acc|Numb=Plur|Gend=Fem
dehinc	dehinc	ADV	Deg=Pos
homines	homo	NOMcom	Case=Acc|Numb=Plur
deus	deus	NOMcom	Case=Nom|Numb=Sing
salutaret	saluto	VER	Numb=Sing|Mood=Sub|Tense=Impa|Voice=Act|Person=3
Tales	talis	PROdem	Case=Acc|Numb=Plur|Gend=MascFem
igitur	igitur	CONcoo	MORPH=empty
habitus	habitus1	NOMcom	Case=Nom|Numb=Plur
qui	qui1	PROrel	Case=Nom|Numb=Plur|Gend=Masc
de	de	PRE	MORPH=empty
natura	natura	NOMcom	Case=Abl|Numb=Sing
et	et2	CONcoo	MORPH=empty
modestia	modestia	NOMcom	Case=Abl|Numb=Sing
transferunt	transfero	VER	Numb=Plur|Mood=Ind|Tense=Pres|Voice=Act|Person=3
et	et2	CONcoo	MORPH=empty
acie	acies	NOMcom	Case=Abl|Numb=Sing
figere	figo	VER	Mood=Inf|Tense=Pres|Voice=Act
et	et2	CONcoo	MORPH=empty
digito	digitus	NOMcom	Case=Abl|Numb=Sing
destinare	destino	VER	Mood=Inf|Tense=Pres|Voice=Act
et	et2	CONcoo	MORPH=empty
nutu	nutus	NOMcom	Case=Abl|Numb=Sing
tradere	trado	VER	Mood=Inf|Tense=Pres|Voice=Act
merito	merito2	ADV	Gend=MascNeut|Deg=Pos
sit	sum1	VER	Numb=Sing|Mood=Sub|Tense=Pres|Voice=Act|Person=3
Prorsus	prorsus2	ADV	Deg=Pos
si	si2	CONsub	MORPH=empty
quis	quis2	PROind	Case=Nom|Numb=Sing|Gend=MascFem
Menandrico	Menandricus	ADJqua	Case=Abl|Numb=Sing|Gend=MascNeut
fluxu	fluxus2	NOMcom	Case=Abl|Numb=Sing|Deg=Pos
delicatam	delicatus2	ADJqua	Case=Acc|Numb=Sing|Gend=Fem|Deg=Pos
vestem	uestis	NOMcom	Case=Acc|Numb=Sing
humi	humus	NOMcom	Case=Loc|Numb=Sing
protrahat	protraho	VER	Numb=Sing|Mood=Sub|Tense=Pres|Voice=Act|Person=3
audiat	audio	VER	Numb=Sing|Mood=Sub|Tense=Pres|Voice=Act|Person=3
penes	penes	PRE	MORPH=empty
se	sui1	PROref	Case=Acc|Numb=Sing
quod	qui1	PROrel	Case=Acc|Numb=Sing
dicit	dico2	VER	Numb=Sing|Mood=Ind|Tense=Pres|Voice=Act|Person=3
comicus	comicus2	ADJqua	Case=Nom|Numb=Sing
Qualem	qualis1	PROrel	Case=Acc|Numb=Sing|Gend=MascFem
demens	demens	ADJqua	Case=Nom|Numb=Sing|Gend=Com|Deg=Pos
iste	iste	PROdem	Case=Nom|Numb=Sing|Gend=Masc
chlamydem	chlamys	NOMcom	Case=Acc|Numb=Sing
disperdit	disperdo	VER	Numb=Sing|Mood=Ind|Tense=Pres|Voice=Act|Person=3
Enimvero	enimuero	ADV	Deg=Pos
iam	iam	ADV	Deg=Pos
dudum	dudum	ADV	Deg=Pos
censoriae	censorius2	ADJqua	Case=Gen|Numb=Sing|Gend=Fem|Deg=Pos
intentionis	intentio	NOMcom	Case=Gen|Numb=Sing
episcynio	episcynium	ADJqua	Case=Dat|Numb=Sing
disperso	dispergo	VER	Case=Abl|Numb=Sing|Gend=MascNeut|Mood=Par|Tense=Perf|Voice=Pass
quantum	quantum1	PROrel	MORPH=empty
denotatui	denotatus	VER	Case=Dat|Numb=Sing
passivitas	passiuitas	NOMcom	Case=Nom|Numb=Sing
offert	offero	VER	Numb=Sing|Mood=Ind|Tense=Pres|Voice=Act|Person=3
libertinos	libertinus1	NOMcom	Case=Acc|Numb=Plur
in	in	PRE	MORPH=empty
equestribus	equestria	ADJqua	Case=Abl|Numb=Plur
subverbustos	subuerbustus	VER	Case=Acc|Numb=Plur|Gend=Masc|Mood=Par|Tense=Perf|Voice=Pass
in	in	PRE	MORPH=empty
liberalibus	liberalis	ADJqua	Case=Abl|Numb=Plur|Gend=Com|Deg=Pos
dediticios	dediticius2	ADJqua	Case=Acc|Numb=Plur|Gend=Masc
in	in	PRE	MORPH=empty
ingenuis	ingenuus	ADJqua	Case=Abl|Numb=Plur|Gend=Com|Deg=Pos
rupices	rupex	NOMcom	Numb=Plur
in	in	PRE	MORPH=empty
urbanis	urbanus	ADJqua	Case=Abl|Numb=Plur|Gend=Com|Deg=Pos
scurras	scurra	NOMcom	Case=Acc|Numb=Plur
in	in	PRE	MORPH=empty
forensibus	forensis	ADJqua	Case=Abl|Numb=Plur|Gend=Com|Deg=Pos
paganos	paganus1	NOMcom	Case=Acc|Numb=Plur
in	in	PRE	MORPH=empty
militaribus	militaris	ADJqua	Case=Abl|Numb=Plur|Gend=Com|Deg=Pos
vespillo	Uespillo	NOMpro	Case=Abl|Numb=Sing
leno	leno1	NOMcom	Case=Nom|Numb=Sing
lanista	lanista	NOMcom	Case=Nom|Numb=Sing
tecum	tu	PROper	Case=Abl|Numb=Sing
{tecum}	cum3	CON	MORPH=empty
vestiuntur	uestio	VER	Numb=Plur|Mood=Ind|Tense=Pres|Voice=Pass|Person=3
Converte	conuerto	VER	Numb=Sing|Mood=Imp|Tense=Pres|Voice=Act|Person=2
et	et2	CONcoo	MORPH=empty
ad	ad2	PRE	MORPH=empty
feminas	femina	NOMcom	Case=Acc|Numb=Plur
Habes	habeo	VER	Numb=Sing|Mood=Ind|Tense=Pres|Voice=Act|Person=2
spectare	specto	VER	Mood=Inf|Tense=Pres|Voice=Act
quod	quod2	CONsub	Case=Acc|Numb=Sing|Gend=Neut
Caecina	Caecina	NOMpro	Case=Nom|Numb=Sing
Severus	Seuerus	NOMpro	Case=Nom|Numb=Sing
graviter	grauiter	ADV	Deg=Pos
senatui	senatus	NOMcom	Case=Dat|Numb=Sing
impressit	imprimo	VER	Numb=Sing|Mood=Ind|Tense=Perf|Voice=Act|Person=3
matronas	matrona	NOMcom	Case=Acc|Numb=Plur
sine	sine	PRE	MORPH=empty
stola	stola	NOMcom	Case=Abl|Numb=Sing
in	in	PRE	MORPH=empty
publico	publicum	NOMcom	Case=Abl|Numb=Sing
Denique	denique	ADV	Deg=Pos
Lentuli	Lentulus	NOMpro	Case=Gen|Numb=Sing
auguris	augur	NOMcom	Case=Gen|Numb=Sing
consultis	consultum	NOMcom	Case=Abl|Numb=Plur|Gend=Com
quae	qui1	PROrel	Case=Nom|Numb=Sing|Gend=Fem
ita	ita	ADV	Deg=Pos
sese	sui1	PROref	Case=Acc|Numb=Sing
exauctorasset	exauctoro	VER	Numb=Sing|Mood=Sub|Tense=Pqp|Voice=Act|Person=3
pro	pro1	PRE	MORPH=empty
stupro	stuprum	NOMcom	Case=Abl|Numb=Sing
erat	sum1	VER	Numb=Sing|Mood=Ind|Tense=Impa|Voice=Act|Person=3
poena	poena	NOMcom	Case=Nom|Numb=Sing
quoniam	quoniam	CONsub	MORPH=empty
quidem	quidem	ADV	Deg=Pos
indices	index	NOMcom	Case=Nom|Numb=Plur
cusodesque	cuso	NOMcom	Numb=Sing
{cusodesque}	que	CON	MORPH=empty
dignitatis	dignitas	NOMcom	Case=Gen|Numb=Sing
habitus	habeo	NOMcom	Case=Nom|Numb=Plur
ut	ut1	ADVrel	MORPH=empty
lenocinii	lenocinium	NOMcom	Case=Nom|Numb=Sing
factitandi	factito	VER	Case=Gen|Numb=Sing|Gend=MascNeut|Mood=Adj|Voice=Pass
impedimenta	impedimentum	NOMcom	Case=Acc|Numb=Plur
sedulo	sedulo	ADV	Deg=Pos
quaedam	quidam	PROind	Case=Acc|Numb=Plur|Gend=Neut
desuefecerant	desuefacio	VER	Numb=Plur|Mood=Ind|Tense=Pqp|Voice=Act|Person=3
At	at2	CONcoo	MORPH=empty
nunc	nunc	ADV	Deg=Pos
in	in	PRE	MORPH=empty
semetipsas	sui	PROref	Case=Acc|Numb=Plur
{semetipsas}	ipse	PROdem	MORPH=empty
lenocinando	lenocinor	VER	Case=Abl|Numb=Sing|Mood=Ger|Voice=Dep
quo	quo1	ADVrel	MORPH=empty
planius	plane	ADV	Deg=Comp
adeantur	adeo1	VER	Numb=Plur|Mood=Sub|Tense=Pres|Voice=Pass|Person=3
et	et2	CONcoo	MORPH=empty
stolam	stola	NOMcom	Case=Acc|Numb=Sing
et	et2	CONcoo	MORPH=empty
supparum	supparum	NOMcom	Case=Acc|Numb=Sing
et	et2	CONcoo	MORPH=empty
crepidulum	crepidulus	NOMcom	Case=Acc|Numb=Sing
et	et2	CONcoo	MORPH=empty
caliendrum	caliendrum	NOMcom	Case=Acc|Numb=Sing
ipsas	ipse	PROdem	Case=Acc|Numb=Plur|Gend=Fem
quoque	quoque	ADV	Deg=Pos
iam	iam	ADV	Deg=Pos
lecticas	lectica	NOMcom	Case=Acc|Numb=Plur
et	et2	CONcoo	MORPH=empty
sellas	sella	NOMcom	Case=Acc|Numb=Plur
quis	quis1	PROrel	Case=Abl|Numb=Plur|Gend=Com
in	in	PRE	MORPH=empty
publico	publicum	NOMcom	Case=Abl|Numb=Sing
quoque	quoque	ADV	Case=Abl|Numb=Sing|Deg=Pos
domestice	domesticus2	ADV	Case=Abl|Numb=Sing|Deg=Pos
ac	ac1	CONcoo	MORPH=empty
secrete	secrete	ADV	Deg=Pos
habebantur	habeo	VER	Numb=Plur|Mood=Ind|Tense=Impa|Voice=Pass|Person=3
eieravere	eiero	VER	Numb=Plur|Mood=Ind|Tense=Perf|Voice=Act|Person=3
Sed	sed	CONcoo	MORPH=empty
alius	alius	PROind	Case=Nom|Numb=Sing|Gend=Masc
extinguit	exstinguo	VER	Numb=Sing|Mood=Ind|Tense=Pres|Voice=Act|Person=3
sua	suus	PROpos.ref	Case=Acc|Numb=Plur|Gend=Neut
lumina	lumen	NOMcom	Case=Acc|Numb=Plur
alius	alius	PROind	Case=Nom|Numb=Sing|Gend=Masc
non	non	ADVneg	MORPH=empty
sua	suus	NOMcom	Case=Acc|Numb=Plur|Gend=Fem
accendit	accendo	VER	Numb=Sing|Mood=Ind|Tense=Pres|Voice=Act|Person=3
Aspice	aspicio	VER	Numb=Sing|Mood=Imp|Tense=Pres|Voice=Act|Person=2
lupas	lupa	NOMcom	Case=Acc|Numb=Plur
popularium	popularis1	NOMcom	Case=Gen|Numb=Plur
libidinum	libido	NOMcom	Case=Gen|Numb=Plur
nundinas	nundinae	NOMcom	Case=Acc|Numb=Plur
ipsas	ipse	PROdem	Case=Acc|Numb=Plur|Gend=Fem
quoque	quoque	ADV	Deg=Pos
frictrices	frictrix	NOMcom	Case=Acc|Numb=Plur
et	et2	CONcoo	MORPH=empty
si	si2	CONsub	MORPH=empty
praestat	praesto1	VER	Numb=Sing|Mood=Ind|Tense=Pres|Voice=Act|Person=3
oculos	oculus	NOMcom	Case=Acc|Numb=Plur
abducere	abduco	VER	Mood=Inf|Tense=Pres|Voice=Act
ab	ab	PRE	MORPH=empty
eiusmodi	eiusmodi	ADV	Deg=Pos
propudiis	propudium	NOMcom	Case=Abl|Numb=Plur
occisae	occido2	VER	Case=Gen|Numb=Sing|Gend=Fem|Mood=Par|Tense=Perf|Voice=Pass
in	in	PRE	MORPH=empty
publico	publicum	NOMcom	Case=Abl|Numb=Sing
castitatis	castitas	NOMcom	Case=Gen|Numb=Sing
aspice	aspicio	VER	Numb=Sing|Mood=Imp|Tense=Pres|Voice=Act|Person=2
tamen	tamen	ADV	Deg=Pos
vel	uel2	CONcoo	MORPH=empty
sublimis	sublimis	ADJqua	Case=Acc|Numb=Sing|Gend=MascFem|Deg=Pos
iam	iam	ADV	Deg=Pos
matronas	matrona	NOMcom	Case=Acc|Numb=Plur
videbis	uideo	VER	Numb=Sing|Mood=Ind|Tense=Fut|Voice=Act|Person=2
Et	et2	CONcoo	MORPH=empty
cum	cum3	CONsub	MORPH=empty
latrinarum	latrina	ADJqua	Case=Gen|Numb=Plur
antistes	antistes	NOMcom	Case=Nom|Numb=Sing
sericum	sericum	NOMcom	Case=Acc|Numb=Sing
ventilat	uentilo	VER	Numb=Sing|Mood=Ind|Tense=Pres|Voice=Act|Person=3
et	et2	CONcoo	MORPH=empty
immundiorem	immundus	ADJqua	Case=Acc|Numb=Sing|Gend=MascFem|Deg=Comp
loco	locus	NOMcom	Case=Abl|Numb=Sing
cervicem	ceruix	NOMcom	Case=Acc|Numb=Sing
monilibus	monile	NOMcom	Case=Abl|Numb=Plur
consolatur	consolor	VER	Numb=Sing|Mood=Ind|Tense=Pres|Voice=Dep|Person=3
et	et2	CONcoo	MORPH=empty
armillis	armilla	NOMcom	Case=Abl|Numb=Plur
quas	qui1	PROrel	Case=Acc|Numb=Plur|Gend=Fem
ex	ex	PRE	MORPH=empty
virorum	uir	NOMcom	Case=Gen|Numb=Plur
fortium	fortis	ADJqua	Case=Gen|Numb=Plur|Gend=Com|Deg=Pos
donis	donum	NOMcom	Case=Abl|Numb=Plur
ipsae	ipse	PROdem	Case=Nom|Numb=Plur|Gend=Fem
quoque	quoque	ADV	Deg=Pos
matronae	matrona	NOMcom	Case=Nom|Numb=Plur
temere	temere	ADV	Deg=Pos
usurpassent	usurpo	VER	Numb=Plur|Mood=Sub|Tense=Pqp|Voice=Act|Person=3
omnium	omnis	PROind	Case=Gen|Numb=Plur|Gend=Com
pudendorum	pudendus	ADJqua	Case=Gen|Numb=Plur|Gend=MascNeut|Deg=Pos
conscias	conscius	ADJqua	Case=Acc|Numb=Sing|Gend=Fem|Deg=Pos
manus	manus1	NOMcom	Case=Acc|Numb=Plur
inserit	insero2	VER	Numb=Sing|Mood=Ind|Tense=Pres|Voice=Act|Person=3
impuro	impurus	ADJqua	Case=Dat|Numb=Sing|Gend=MascNeut|Deg=Pos
cruri	crus	NOMcom	Case=Dat|Numb=Sing
purum	purus	ADJqua	Case=Acc|Numb=Sing|Gend=MascNeut|Deg=Pos
aut	aut	CONcoo	MORPH=empty
mulleolum	mulleolum	NOMcom	Case=Acc|Numb=Sing
inducit	induco	VER	Numb=Sing|Mood=Ind|Tense=Pres|Voice=Act|Person=3
calceum	calceus	NOMcom	Case=Acc|Numb=Sing
cur	cur	ADVint	MORPH=empty
istos	iste	PROdem	Case=Acc|Numb=Plur|Gend=Masc
non	non	ADVneg	MORPH=empty
spectas	specto	VER	Numb=Sing|Mood=Ind|Tense=Pres|Voice=Act|Person=2
vel	uel2	CONcoo	MORPH=empty
illos	ille	PROdem	Case=Acc|Numb=Plur|Gend=Masc
item	item	ADV	Deg=Pos
habitus	habitus1	NOMcom	Case=Acc|Numb=Plur
qui	qui1	PROrel	Case=Nom|Numb=Plur|Gend=Masc
novitati	nouitas	NOMcom	Case=Dat|Numb=Sing
suae	suus	PROpos.ref	Case=Dat|Numb=Sing|Gend=Fem
stare	sto	VER	Mood=Inf|Tense=Pres|Voice=Act
religionem	religio	NOMcom	Case=Acc|Numb=Sing
mentiuntur	mentior	VER	Numb=Plur|Mood=Ind|Tense=Pres|Voice=Dep|Person=3
cum	cum3	CONsub	MORPH=empty
ob	ob	PRE	MORPH=empty
cultum	cultus1	NOMcom	Case=Acc|Numb=Sing
omnia	omnis	PROind	Case=Acc|Numb=Plur|Gend=Neut
candidatum	candidatus1	NOMcom	Case=Acc|Numb=Sing
et	et2	CONcoo	MORPH=empty
ob	ob	PRE	MORPH=empty
notam	nota	NOMcom	Case=Acc|Numb=Sing|Deg=Pos
vittae	uitta	NOMcom	Case=Nom|Numb=Plur
et	et2	CONcoo	MORPH=empty
privilegium	priuilegium	NOMcom	Case=Acc|Numb=Sing
galeri	galerus	NOMcom	Case=Gen|Numb=Sing
Cereri	Ceres	NOMpro	Case=Gen|Numb=Sing
initiantur	initio	VER	Numb=Plur|Mood=Ind|Tense=Pres|Voice=Pass|Person=3
cum	cum3	CONsub	MORPH=empty
ob	ob	PRE	MORPH=empty
diversam	diuersus	ADJqua	Case=Acc|Numb=Sing|Gend=Fem|Deg=Pos
affectionem	affectio	NOMcom	Case=Acc|Numb=Sing
tenebricae	tenebricus	ADJqua	Case=Gen|Numb=Sing|Gend=Fem|Deg=Pos
vestis	uestis	NOMcom	Case=Gen|Numb=Sing
et	et2	CONcoo	MORPH=empty
tetrici	tetricus	NOMcom	Case=Gen|Numb=Sing|Gend=MascNeut|Deg=Pos
super	super2	PRE	MORPH=empty
caput	caput	NOMcom	Case=Acc|Numb=Sing
velleris	uellus	NOMcom	Case=Gen|Numb=Sing
in	in	PRE	MORPH=empty
Bellonae	Bellona	NOMpro	Case=Gen|Numb=Sing
mentes	mens	NOMcom	Case=Nom|Numb=Plur
fugantur	fugo	VER	Numb=Plur|Mood=Ind|Tense=Pres|Voice=Pass|Person=3
cum	cum3	CONsub	MORPH=empty
latioris	latus2	ADJqua	Case=Gen|Numb=Sing|Gend=Com|Deg=Comp
purpurae	purpura	NOMcom	Case=Gen|Numb=Sing
ambitio	ambitio	NOMcom	Case=Nom|Numb=Sing
et	et2	CONcoo	MORPH=empty
Galatici	Galaticus	ADJqua	Case=Gen|Numb=Sing|Gend=MascNeut|Deg=Pos
ruboris	rubor	NOMcom	Case=Gen|Numb=Sing
superiectio	superiectio	NOMcom	Case=Nom|Numb=Sing
Saturnum	Saturnus	NOMpro	Case=Acc|Numb=Sing
commendat	commendo	VER	Numb=Sing|Mood=Ind|Tense=Pres|Voice=Act|Person=3
Cum	cum3	CONsub	MORPH=empty
ipsum	ipse	PROdem	Case=Nom|Numb=Sing|Gend=MascNeut
hoc	hic1	PROdem	Case=Nom|Numb=Sing|Gend=Neut
pallium	pallium	NOMcom	Case=Nom|Numb=Sing
morosius	morosus	ADJqua	Gend=Neut|Deg=Comp
ordinatum	ordino	VER	Case=Nom|Numb=Sing|Gend=Neut
et	et2	CONcoo	MORPH=empty
crepidae	crepida	ADJqua	Case=Nom|Numb=Plur
Graecatim	Graecatis	ADV	Deg=Pos
Aesculapio	Aesculapius	NOMpro	Case=Dat|Numb=Sing
adulantur	adulor	VER	Numb=Plur|Mood=Ind|Tense=Pres|Voice=Dep|Person=3
quanto	quanto1	ADVrel	MORPH=empty
tunc	tunc	ADV	Deg=Pos
magis	magis2	ADV	Deg=Comp
arguas	arguo	VER	Numb=Sing|Mood=Sub|Tense=Pres|Voice=Act|Person=2
illud	ille	PROdem	Case=Acc|Numb=Sing|Gend=Neut
et	et2	CONcoo	MORPH=empty
urgeas	urgeo	VER	Numb=Sing|Deg=Pos|Mood=Sub|Tense=Pres|Voice=Act|Person=2
oculis	oculus	NOMcom	Case=Abl|Numb=Plur
etsi	etsi2	CONsub	MORPH=empty
iam	iam	ADV	Deg=Pos
simplicis	simplex	ADJmul	Case=Gen|Numb=Sing|Gend=Com|Deg=Pos
et	et2	CONcoo	MORPH=empty
inaffectatae	inaffecto	ADJqua	Case=Gen|Numb=Sing|Gend=Fem|Deg=Pos|Mood=Par|Tense=Perf|Voice=Pass
tamen	tamen	ADV	Deg=Pos
superstitionis	superstitio	NOMcom	Case=Gen|Numb=Sing
reum	reus	NOMcom	Case=Acc|Numb=Sing
Enimvero	enimuero	ADV	Deg=Pos
cum	cum3	CONsub	MORPH=empty
hanc	hic1	PROdem	Case=Acc|Numb=Sing|Gend=Fem
primum	primum	ADJadv.ord	Deg=Sup
sapientiam	sapientia	NOMcom	Case=Acc|Numb=Sing
vestit	uestio	VER	Numb=Sing|Mood=Ind|Tense=Pres|Voice=Act|Person=3
quae	qui1	PROrel	Case=Nom|Numb=Sing|Gend=Fem
vanissimis	uanus	ADJqua	Case=Abl|Numb=Plur|Gend=Com|Deg=Sup
superstitionibus	superstitio	NOMcom	Case=Abl|Numb=Plur
renuit	renuo	VER	Numb=Sing|Mood=Ind|Tense=Pres|Voice=Act|Person=3
tunc	tunc	ADV	Deg=Pos
certissime	certe	ADV	Deg=Sup
pallium	pallium	NOMcom	Case=Nom|Numb=Sing
super	super2	PRE	MORPH=empty
omnes	omnis	PROind	Case=Acc|Numb=Plur|Gend=MascFem
exuvias	exuuiae	NOMcom	Case=Acc|Numb=Plur
et	et2	CONcoo	MORPH=empty
peplos	peplus	NOMcom	Case=Acc|Numb=Plur
augusta	augustus	ADJqua	Case=Acc|Numb=Sing|Gend=Fem|Deg=Pos
vestis	uestis	NOMcom	Case=Acc|Numb=Plur
superque	super	PRE	MORPH=empty
{superque}	que	CON	MORPH=empty
omnes	omnis	PROind	Case=Acc|Numb=Plur|Gend=MascFem
apices	apex	NOMcom	Case=Acc|Numb=Plur
et	et2	CONcoo	MORPH=empty
tutulos	tutulus	NOMcom	Case=Acc|Numb=Plur|Gend=Masc
sacerdos	sacerdos	NOMcom	Case=Nom|Numb=Sing
suggestus	suggestus	NOMcom	Case=Nom|Numb=Sing
Deduc	deduco	VER	Numb=Sing|Mood=Imp|Tense=Pres|Voice=Act|Person=2
oculos	oculus	NOMcom	Case=Acc|Numb=Plur
suadeo	suadeo	VER	Numb=Sing|Mood=Ind|Tense=Pres|Voice=Act|Person=1
reverere	reuereor	VER	Numb=Sing|Mood=Imp|Tense=Pres|Voice=Dep|Person=2
habitum	habitus1	NOMcom	Case=Acc|Numb=Sing
unius	unus	ADJcar	Case=Gen|Numb=Sing|Gend=Com
interim	interim	ADV	Deg=Pos
erroris	error	NOMcom	Case=Gen|Numb=Sing
tui	tuus	PROpos	Case=Gen|Numb=Sing|Gend=MascNeut
renuntiatorem	renuntiator	NOMcom	Case=Acc|Numb=Sing
Tamen	tamen	ADV	Deg=Pos
inquis	inquio	VER	Numb=Sing|Mood=Ind|Tense=Pres|Voice=Act|Person=2
ita	ita	ADV	Deg=Pos
a	ab	PRE	MORPH=empty
toga	toga	NOMcom	Case=Abl|Numb=Sing
ad	ad2	PRE	MORPH=empty
pallium	pallium	NOMcom	Case=Acc|Numb=Sing
Quid	quis1	PROint	Case=Acc|Numb=Sing|Gend=Neut
enim	enim2	CONcoo	MORPH=empty
si	si2	CONsub	MORPH=empty
a	ab	PRE	MORPH=empty
diademate	diadema	NOMcom	Case=Abl|Numb=Sing
et	et2	CONcoo	MORPH=empty
a	ab	PRE	MORPH=empty
sceptro	sceptrum	NOMcom	Case=Abl|Numb=Sing
An	an	ADVint	MORPH=empty
aliter	aliter	ADV	Deg=Pos
mutavit	muto2	VER	Numb=Sing|Mood=Ind|Tense=Perf|Voice=Act|Person=3
Anacharsis	Anacharsis	NOMpro	Case=Nom|Numb=Sing
cum	cum2	PRE	MORPH=empty
regno	regnum	NOMcom	Case=Abl|Numb=Sing
Scythiae	Scythia	NOMpro	Case=Gen|Numb=Sing
philosophiam	philosophia	NOMcom	Case=Acc|Numb=Sing
praevertit	praeuerto	VER	Numb=Sing|Mood=Ind|Tense=Perf|Voice=Act|Person=3
Nulla	nullus	PROind	Case=Nom|Numb=Plur|Gend=Neut
in	in	PRE	MORPH=empty
melius	bonus	ADJqua	Case=Acc|Numb=Sing|Gend=Neut|Deg=Comp
transgressi	transgredior	VER	Case=Nom|Numb=Plur|Gend=Masc|Mood=Par|Tense=Perf|Voice=Dep
sint	sum1	VER	Numb=Plur|Mood=Sub|Tense=Pres|Voice=Act|Person=3
signa	signum	NOMcom	Case=Nom|Numb=Plur
est	sum1	VER	Numb=Sing|Mood=Ind|Tense=Pres|Voice=Act|Person=3
habitus	habitus1	NOMcom	Case=Nom|Numb=Sing
iste	iste	PROdem	Case=Nom|Numb=Sing|Gend=Masc
quod	qui1	PROrel	Case=Acc|Numb=Sing|Gend=Neut
faciat	facio	VER	Numb=Sing|Mood=Sub|Tense=Pres|Voice=Act|Person=3
Prius	prius	ADJadv.ord	Deg=Comp
etiam	etiam	ADV	Deg=Pos
ad	ad2	PRE	MORPH=empty
simplicem	simplex	ADJmul	Case=Acc|Numb=Sing|Gend=MascFem|Deg=Pos
captatelam	captatela	NOMcom	Case=Acc|Numb=Sing
eius	is	PROdem	Case=Gen|Numb=Sing|Gend=Com
nullo	nullus	PROind	Case=Abl|Numb=Sing|Gend=MascNeut
taedio	taedium	NOMcom	Case=Abl|Numb=Sing
constat	consto	VER	Numb=Sing|Mood=Ind|Tense=Pres|Voice=Act|Person=3
Adeo	adeo2	ADV	Deg=Pos
nec	nec2	CONcoo	MORPH=empty
artificem	artifex	NOMcom	Case=Acc|Numb=Sing
necesse	necesse	ADJqua	Case=Ind|Deg=Pos
est	sum1	VER	Numb=Sing|Mood=Ind|Tense=Pres|Voice=Act|Person=3
qui	qui1	PROrel	Case=Nom|Numb=Sing|Gend=Masc
pridie	pridie	ADV	Deg=Pos
rugas	ruga	NOMcom	Case=Acc|Numb=Plur
ab	ab	PRE	MORPH=empty
exordio	exordium	NOMcom	Case=Abl|Numb=Sing
formet	formo	VER	Numb=Sing|Mood=Sub|Tense=Pres|Voice=Act|Person=3
et	et2	CONcoo	MORPH=empty
inde	inde	ADV	Deg=Pos
deducat	deduco	VER	Numb=Sing|Mood=Sub|Tense=Pres|Voice=Act|Person=3
nitidius	nitidus	ADJqua	Case=Nom|Numb=Sing|Deg=Comp
totumque	totus	PROind	Case=Acc|Numb=Sing|Gend=MascNeut
{totumque}	que	CON	MORPH=empty
contracti	contraho	VER	Case=Gen|Numb=Sing|Gend=MascNeut|Mood=Par|Tense=Perf|Voice=Pass
umbonis	umbo	NOMcom	Case=Gen|Numb=Sing
figmentum	figmentum	NOMcom	Case=Acc|Numb=Sing
custodibus	custos	NOMcom	Case=Abl|Numb=Plur
forcipibus	forceps	NOMcom	Case=Abl|Numb=Plur
assignet	assigno	VER	Numb=Sing|Mood=Sub|Tense=Pres|Voice=Act|Person=3
dehinc	dehinc	ADV	Deg=Pos
diluculo	diluculum	NOMcom	Case=Abl|Numb=Sing
tunica	tunica	NOMcom	Case=Abl|Numb=Sing
prius	prius	ADJadv.ord	Deg=Comp
cingulo	cingulum	NOMcom	Case=Abl|Numb=Sing
correpta	corripio	VER	Case=Nom|Numb=Sing|Gend=Fem|Mood=Par|Tense=Perf|Voice=Pass
quam	quam1	PROrel	Numb=Sing|Gend=Fem
praestabat	praesto1	VER	Numb=Sing|Mood=Ind|Tense=Impa|Voice=Act|Person=3
moderatiorem	moderatus	ADJqua	Case=Acc|Numb=Sing|Gend=MascFem|Deg=Comp
texuisse	texo	VER	Mood=Inf|Tense=Perf|Voice=Act
recognito	recognosco	VER	Case=Abl|Numb=Sing|Gend=MascNeut|Mood=Par|Tense=Perf|Voice=Pass
rursus	rursus	ADV	Deg=Pos
umbone	umbo	NOMcom	Case=Abl|Numb=Sing
et	et2	CONcoo	MORPH=empty
si	si2	CONsub	MORPH=empty
quid	quis2	PROind	Case=Acc|Numb=Sing|Gend=Neut
exorbitavit	exsorbito	VER	Numb=Sing|Mood=Ind|Tense=Perf|Voice=Act|Person=3
reformato	reformo	VER	Case=Abl|Numb=Sing|Gend=MascNeut|Mood=Par|Tense=Perf|Voice=Pass
partem	pars	NOMcom	Case=Acc|Numb=Sing
quidem	quidem	ADV	Deg=Pos
de	de	PRE	MORPH=empty
laevo	laeuum1	NOMcom	Case=Abl|Numb=Sing
promittat	promitto	VER	Numb=Sing|Mood=Sub|Tense=Pres|Voice=Act|Person=3
ambitum	ambitus	NOMcom	Case=Acc|Numb=Sing
vero	uero4	CONcoo	MORPH=empty
eius	is	PROdem	Case=Gen|Numb=Sing|Gend=Com
ex	ex	PRE	MORPH=empty
quo	qui1	PROrel	Case=Abl|Numb=Sing|Gend=MascNeut
sinus	sinus	NOMcom	Case=Nom|Numb=Sing
nascitur	nascor	VER	Numb=Sing|Mood=Ind|Tense=Pres|Voice=Dep|Person=3
iam	iam	ADV	Deg=Pos
deficientibus	deficio	VER	Case=Abl|Numb=Plur|Gend=Com|Mood=Par|Tense=Pres|Voice=Act
tabulis	tabula	NOMcom	Case=Abl|Numb=Plur
retrahat	retraho	VER	Numb=Sing|Mood=Sub|Tense=Pres|Voice=Act|Person=3
a	ab	PRE	MORPH=empty
scapulis	scapula	NOMcom	Case=Abl|Numb=Plur
et	et2	CONcoo	MORPH=empty
exclusa	excludo	VER	Case=Nom|Numb=Sing|Gend=Fem|Mood=Par|Tense=Perf|Voice=Pass
dextera	dextera	NOMcom	Case=Abl|Numb=Sing
in	in	PRE	MORPH=empty
laevam	laeua1	NOMcom	Case=Acc|Numb=Sing
adhuc	adhuc	ADV	Deg=Pos
congerat	congero2	VER	Numb=Sing|Mood=Sub|Tense=Pres|Voice=Act|Person=3
cum	cum3	CONsub	MORPH=empty
alio	alius	PROind	Case=Abl|Numb=Sing|Gend=MascNeut
pari	par2	ADJqua	Case=Abl|Numb=Sing|Gend=Com|Deg=Pos
tabulto	tabultum	NOMcom	Case=Abl|Numb=Sing
in	in	PRE	MORPH=empty
terga	tergum	NOMcom	Case=Acc|Numb=Plur
devoto	deuoueo	VER	Case=Abl|Numb=Sing|Gend=MascNeut
atque	atque1	CONcoo	MORPH=empty
ita	ita	ADV	Deg=Pos
hominem	homo	NOMcom	Case=Acc|Numb=Sing
sarcina	sarcina	NOMcom	Case=Abl|Numb=Sing
vestiat	uestio	VER	Numb=Sing|Mood=Sub|Tense=Pres|Voice=Act|Person=3
Conscientiam	conscientia	NOMcom	Case=Acc|Numb=Sing
denique	denique	ADV	Deg=Pos
tuam	tuus	PROpos	Case=Acc|Numb=Sing|Gend=Fem
perrogabo	perrogo	VER	Numb=Sing|Mood=Ind|Tense=Fut|Voice=Act|Person=1
quid	quis1	PROint	Case=Acc|Numb=Sing|Gend=Neut
te	tu	PROper	Case=Acc|Numb=Sing
prius	prius	ADJord	Gend=Neut|Deg=Comp
in	in	PRE	MORPH=empty
toga	toga	NOMcom	Case=Abl|Numb=Sing
sentias	sentio	VER	Numb=Sing|Mood=Sub|Tense=Pres|Voice=Act|Person=2
indutum	induo	VER	Case=Acc|Numb=Sing|Gend=MascNeut|Mood=Par|Tense=Perf|Voice=Pass
anne	anne	ADVint	MORPH=empty
onustum	onustus	ADJqua	Case=Acc|Numb=Sing|Gend=MascNeut|Deg=Pos
habene	habeo	VER	Numb=Sing|Mood=Imp|Tense=Pres|Voice=Act
{habene}	ne2	ADV	MORPH=empty
vestem	uestis	NOMcom	Case=Acc|Numb=Sing
an	an	ADVint	MORPH=empty
haiulare	haiulo	VER	MORPH=empty
Si	si2	CONsub	MORPH=empty
negabis	nego	VER	Numb=Sing|Mood=Ind|Tense=Fut|Voice=Act|Person=2
domum	domus	NOMcom	Case=Acc|Numb=Sing
consequar	consequor	VER	Numb=Sing|Mood=Ind|Tense=Fut|Voice=Dep|Person=1
videbo	uideo	VER	Numb=Sing|Mood=Ind|Tense=Fut|Voice=Act|Person=1
quid	quis1	PROint	Case=Acc|Numb=Sing|Gend=Neut
statim	statim	ADV	Deg=Pos
a	ab	PRE	MORPH=empty
limine	limen	NOMcom	Case=Abl|Numb=Sing
properes	propero	VER	Numb=Sing|Mood=Sub|Tense=Pres|Voice=Act|Person=2
Nullius	nullus	PROind	Case=Gen|Numb=Sing|Gend=Com
profecto	profecto	ADV	Deg=Pos
alterius	alter	PROind	Case=Gen|Numb=Sing|Gend=Com
indumenti	indumentum	VER	Case=Gen|Numb=Sing
expositio	expositio	NOMcom	Case=Nom|Numb=Sing
quam	quam1	ADVrel	Gend=Fem
togae	toga	NOMcom	Case=Gen|Numb=Sing
gratulatur	gratulor	VER	Numb=Sing|Mood=Ind|Tense=Pres|Voice=Dep|Person=3
Calceos	calceus	NOMpro	Case=Acc|Numb=Plur
nihil	nihil	PROind	Case=Ind
dicimus	dico2	VER	Numb=Plur|Mood=Ind|Tense=Pres|Voice=Act|Person=1
proprium	proprius	ADJqua	Case=Acc|Numb=Sing|Gend=MascNeut|Deg=Pos
togae	toga	NOMcom	Case=Gen|Numb=Sing
tormentum	tormentum	NOMcom	Case=Acc|Numb=Sing
immundissimam	immundus	ADJqua	Case=Acc|Numb=Sing|Gend=Fem|Deg=Sup
pedum	pes	NOMcom	Case=Gen|Numb=Plur
tutelam	tutela	NOMcom	Case=Acc|Numb=Sing
verum	uerum4	ADJqua	Case=Acc
et	et2	CONcoo	MORPH=empty
falsam	falsus	ADJqua	Case=Acc|Numb=Sing|Gend=Fem|Deg=Pos
Quem	qui1	PROrel	Case=Acc|Numb=Sing|Gend=Masc
enim	enim2	CONcoo	MORPH=empty
non	non	ADVneg	MORPH=empty
expediat	expedio	VER	Numb=Sing|Mood=Sub|Tense=Pres|Voice=Act|Person=3
in	in	PRE	MORPH=empty
algore	algor	NOMcom	Case=Abl|Numb=Sing
et	et2	CONcoo	MORPH=empty
ardore	ardor	NOMcom	Case=Abl|Numb=Sing
rigere	rigeo	VER	Mood=Inf|Tense=Pres|Voice=Act
nudipedem	nudipes	NOMcom	Case=Acc|Numb=Sing|Gend=MascFem
quam	quam1	ADVrel	MORPH=empty
in	in	PRE	MORPH=empty
calceo	calceus	NOMcom	Case=Abl|Numb=Sing
vincipedem	uincipes	NOMcom	Case=Acc|Numb=Sing|Gend=MascFem
Magnum	magnus	ADJqua	Case=Acc|Numb=Sing|Gend=MascNeut|Deg=Pos
incessui	incessus	VER	Numb=Sing
munimentum	munimentum	NOMcom	Case=Acc|Numb=Sing
sutrinae	sutrinus	ADJqua	Case=Gen|Numb=Sing|Gend=Fem|Deg=Pos
Venetiae	Uenetia	NOMpro	Case=Gen|Numb=Sing
prospexere	prospicio	VER	Mood=Ind|Tense=Perf|Voice=Act|Person=3
perones	pero	NOMcom	Case=Acc|Numb=Plur
effeminatos	effeminatus	ADJqua	Case=Acc|Numb=Plur|Gend=Masc
At	at2	CONcoo	MORPH=empty
enim	enim2	CONcoo	MORPH=empty
pallio	pallium	NOMcom	Case=Abl|Numb=Sing
nihil	nihil	PROind	Case=Ind
expeditius	expeditus	ADJqua	Case=Acc|Gend=Neut|Deg=Comp
etiam	etiam	ADV	Deg=Pos
si	si2	CONsub	MORPH=empty
duplex	duplex	ADJmul	Case=Nom|Numb=Sing|Gend=Com|Deg=Pos
quod	qui1	PROrel	Numb=Sing|Gend=Neut
Cratetis	crateta	NOMpro	Case=Dat|Numb=Sing
Mera	merus	NOMcom	Case=Nom|Numb=Sing|Gend=Fem
nusquam	nusquam	ADVneg	MORPH=empty
vestiendo	uestio	VER	Case=Abl|Numb=Sing|Mood=Ger|Voice=Act
imponitur	impono	VER	Numb=Sing|Mood=Ind|Tense=Pres|Voice=Pass|Person=3
quippe	quippe2	CONcoo	MORPH=empty
tota	totus	PROind	Case=Nom|Numb=Sing|Gend=Fem
molitio	molitio1	NOMcom	Case=Nom|Numb=Sing
eius	is	PROdem	Case=Gen|Numb=Sing|Gend=Com
operire	operio	VER	Mood=Inf|Tense=Pres|Voice=Act
est	sum1	VER	Numb=Sing|Mood=Ind|Tense=Pres|Voice=Act|Person=3
solutim	solutim	ADV	Deg=Pos
Id	is	PROdem	Case=Nom|Numb=Sing|Gend=Neut
ex	ex	PRE	MORPH=empty
uno	unus	ADJcar	Case=Abl|Numb=Sing|Gend=MascNeut
circumiectu	circuitiectus	NOMcom	Case=Abl|Numb=Sing
licet	licet1	VER	Numb=Sing|Mood=Ind|Tense=Pres|Voice=Act|Person=3
equidem	equidem	ADV	Deg=Pos
nusquam	nusquam	ADVneg	MORPH=empty
inhumano	inhumanus	ADJqua	Case=Abl|Numb=Sing|Gend=MascNeut|Deg=Pos
ita	ita	ADV	Deg=Pos
omnia	omnis	PROind	Case=Acc|Numb=Plur|Gend=Neut
hominis	homo	NOMcom	Case=Gen|Numb=Sing
simul	simul1	ADV	Deg=Pos
contegit	contego	VER	Numb=Sing|Mood=Ind|Tense=Pres|Voice=Act|Person=3
Humerum	humerus	NOMcom	Case=Acc|Numb=Sing
velans	uelo	VER	Case=Nom|Numb=Sing|Gend=Com|Mood=Par|Tense=Pres|Voice=Act
exponit	expono	VER	Numb=Sing|Mood=Ind|Tense=Pres|Voice=Act|Person=3
vel	uel2	CONcoo	MORPH=empty
includit	includo	VER	Numb=Sing|Mood=Ind|Tense=Pres|Voice=Act|Person=3
ceteroquin	ceteroquor	NOMcom	Case=Nom|Numb=Sing|Deg=Pos
humerum	humerus	NOMcom	Case=Acc|Numb=Sing
adhaeret	adhaereo	VER	Numb=Sing|Mood=Ind|Tense=Pres|Voice=Act|Person=3
nihil	nihil	PROind	Case=Ind
circumfulcit	circumfulcio	VER	Numb=Sing|Mood=Ind|Tense=Pres|Voice=Act|Person=3
nihil	nihil	PROind	Case=Ind
circumstringit	circumstringo	VER	Numb=Sing|Mood=Ind|Tense=Pres|Voice=Act|Person=3
nihil	nihil	PROind	Case=Ind
de	de	PRE	MORPH=empty
tabularum	tabula	NOMcom	Case=Gen|Numb=Plur
fide	fides2	NOMcom	Case=Abl|Numb=Sing
laborat	laboro	VER	Numb=Sing|Mood=Ind|Tense=Pres|Voice=Act|Person=3
facile	facile	ADV	Deg=Pos
sese	sui1	PROref	Case=Acc|Numb=Sing
regit	rego	VER	Numb=Sing|Mood=Ind|Tense=Pres|Voice=Act|Person=3
facile	facile	ADV	Deg=Pos
reficit	reficio	VER	Numb=Sing|Mood=Ind|Tense=Pres|Voice=Act|Person=3
etiam	etiam	ADV	Deg=Pos
cum	cum3	CONsub	MORPH=empty
exponitur	expono	VER	Numb=Sing|Mood=Ind|Tense=Pres|Voice=Pass|Person=3
nulli	nullus	PROind	Case=Dat|Numb=Sing|Gend=Com
cruci	crux	NOMcom	Case=Dat|Numb=Sing
in	in	PRE	MORPH=empty
crastinum	crastinum	NOMcom	Case=Acc|Numb=Sing
demandatur	demando2	VER	Numb=Sing|Mood=Ind|Tense=Pres|Voice=Pass|Person=3
Si	si2	CONsub	MORPH=empty
quid	quis2	PROind	Case=Nom|Numb=Sing|Gend=Neut
interulae	interula	NOMcom	Case=Gen|Numb=Sing
subter	subter2	PRE	MORPH=empty
est	sum1	VER	Numb=Sing|Mood=Ind|Tense=Pres|Voice=Act|Person=3
vacat	uaco	VER	Numb=Sing|Mood=Ind|Tense=Pres|Voice=Act|Person=3
zonae	zona	NOMcom	Case=Gen|Numb=Sing
tormentum	tormentum	NOMcom	Case=Acc|Numb=Sing
si	si2	CONsub	MORPH=empty
quid	quis2	PROind	Case=Acc|Numb=Sing|Gend=Neut
calceatus	calceo	VER	Case=Nom|Numb=Sing|Mood=Par|Tense=Perf|Voice=Pass
inducitur	induco	VER	Numb=Sing|Mood=Ind|Tense=Pres|Voice=Pass|Person=3
mundissimum	mundus2	ADJqua	Case=Nom|Numb=Sing|Gend=Neut|Deg=Sup
opus	opus2	NOMcom	Case=Ind
est	sum1	VER	Numb=Sing|Mood=Ind|Tense=Pres|Voice=Act|Person=3
aut	aut	CONcoo	MORPH=empty
pedes	pes	NOMcom	Case=Nom|Numb=Sing
nudi	nudus	ADJqua	Case=Gen|Numb=Plur|Gend=Masc|Deg=Pos
magis	magis2	ADV	Deg=Comp
certe	certe	ADV	Deg=Pos
viriles	uirilis	ADJqua	Case=Nom|Numb=Plur|Gend=MascFem|Deg=Pos
magis	magis2	ADV	Deg=Comp
quam	quam1	ADVrel	MORPH=empty
in	in	PRE	MORPH=empty
calceis	calceus	NOMcom	Case=Abl|Numb=Plur
Haec	hic1	PROdem	Case=Acc|Numb=Plur|Gend=Neut
pro	pro1	PRE	MORPH=empty
pallio	pallium	NOMcom	Case=Abl|Numb=Sing
interim	interim	ADV	Deg=Pos
quantum	quantum3	ADVrel	Case=Acc
nomine	nomen	NOMcom	Case=Abl|Numb=Sing
comitiasti	comitio	VER	Numb=Sing|Mood=Ind|Tense=Perf|Voice=Act|Person=2
Iam	iam	ADV	Deg=Pos
vere	uere	ADV	Case=Abl|Deg=Pos
et	et2	CONcoo	MORPH=empty
de	de	PRE	MORPH=empty
negotio	negotium	NOMcom	Case=Abl|Numb=Sing
provocat	prouoco	VER	Numb=Sing|Mood=Ind|Tense=Pres|Voice=Act|Person=3
Ego	ego	PROper	Case=Nom|Numb=Sing
inquit	inquio	VER	Numb=Sing|Mood=Ind|Tense=Pres|Voice=Act|Person=3
nihil	nihil	PROind	Case=Ind
fore	sum1	VER	Mood=Par|Tense=Fut|Voice=Act
nihil	nihil	PROind	Case=Ind
campo	campus1	NOMcom	Case=Dat|Numb=Sing
nihil	nihil	PROind	Case=Ind
curiae	curia	NOMcom	Case=Dat|Numb=Sing
debeo	debeo	VER	Numb=Sing|Mood=Ind|Tense=Pres|Voice=Act|Person=1
nihil	nihil	PROind	Case=Ind
officio	officium	NOMcom	Case=Abl|Numb=Sing
advigilo	aduigilo	NOMcom	Case=Abl|Numb=Sing|Deg=Pos
nulla	nullus	PROind	Case=Acc|Numb=Plur|Gend=Neut
rostra	rostrum	NOMcom	Case=Acc|Numb=Plur
praeoccupo	praeoccupus	VER	Numb=Sing
nulla	nullus	PROind	Case=Acc|Numb=Plur|Gend=Neut
praetoria	praetorius1	NOMcom	Case=Acc|Numb=Plur|Gend=Neut|Deg=Pos
observo	obseruo	VER	Numb=Sing|Mood=Ind|Tense=Pres|Voice=Act|Person=1
canales	canalis1	NOMcom	Case=Acc|Numb=Plur
non	non	ADVneg	MORPH=empty
odoro	odorus	VER	Case=Abl|Numb=Sing|Deg=Pos|Mood=Ind|Tense=Pres|Voice=Act
cancellos	cancellus	NOMcom	Case=Acc|Numb=Plur
non	non	ADVneg	MORPH=empty
adoro	adoro	VER	Numb=Sing|Mood=Ind|Tense=Pres|Voice=Act|Person=1
subsellia	subsellium	NOMcom	Case=Acc|Numb=Plur
non	non	ADVneg	MORPH=empty
contundo	contundo	ADJqua	Numb=Sing|Mood=Ind|Tense=Pres|Voice=Act|Person=1
iura	ius1	NOMcom	Case=Acc|Numb=Plur
non	non	ADVneg	MORPH=empty
conturbo	conturbo2	VER	Numb=Sing|Mood=Ind|Tense=Pres|Voice=Act|Person=1
causas	causa	NOMcom	Case=Acc|Numb=Plur
non	non	ADVneg	MORPH=empty
elatro	elatro2	NOMcom	Numb=Sing
non	non	ADVneg	MORPH=empty
iudico	iudico	VER	Numb=Sing|Mood=Ind|Tense=Pres|Voice=Act|Person=1
non	non	ADVneg	MORPH=empty
milito	miles	NOMcom	Case=Dat|Numb=Sing
non	non	ADVneg	MORPH=empty
regno	regnum	NOMcom	Case=Abl|Numb=Sing
secessi	secedo1	VER	Numb=Sing|Mood=Ind|Tense=Perf|Voice=Act|Person=1
de	de	PRE	MORPH=empty
populo	populus1	NOMcom	Case=Abl|Numb=Sing
In	in	PRE	MORPH=empty
me	ego	PROper	Case=Acc|Numb=Sing
unicum	unicus	ADJqua	Case=Nom|Numb=Sing|Gend=Neut|Deg=Pos
negotium	negotium	NOMcom	Case=Nom|Numb=Sing
mihi	ego	PROper	Case=Dat|Numb=Sing
est	sum1	VER	Numb=Sing|Mood=Ind|Tense=Pres|Voice=Act|Person=3
nisi	nisi	CONsub	MORPH=empty
aliud	alius	PROind	Case=Nom|Numb=Sing|Gend=Neut
non	non	ADVneg	MORPH=empty
curo	curo	VER	Numb=Sing|Mood=Ind|Tense=Pres|Voice=Act|Person=1
quam	quam1	ADVrel	MORPH=empty
ne	ne4	CONsub	MORPH=empty
curem	curo	VER	Numb=Sing|Mood=Sub|Tense=Pres|Voice=Act|Person=1
Vita	uita	NOMcom	Case=Abl|Numb=Sing
meliore	bonus	ADJqua	Case=Abl|Numb=Sing|Gend=Com|Deg=Comp
magis	magis2	ADV	Deg=Comp
in	in	PRE	MORPH=empty
secessu	secessus	NOMcom	Case=Abl|Numb=Sing
fruare	fruor	VER	Numb=Sing|Mood=Sub|Tense=Pres|Voice=Dep|Person=2
quam	quam1	ADVrel	MORPH=empty
in	in	PRE	MORPH=empty
promptu	promptus1	NOMcom	Case=Abl|Numb=Sing
Sed	sed	CONcoo	MORPH=empty
ignavam	ignauus2	ADJqua	Case=Acc|Numb=Sing|Gend=Fem|Deg=Pos
infamabis	infamo	VER	Numb=Sing|Mood=Ind|Tense=Fut|Voice=Act|Person=2
Scilicet	scilicet	ADV	Deg=Pos
patriae	patria	NOMcom	Case=Dat|Numb=Sing
et	et2	CONcoo	MORPH=empty
imperio	imperium	NOMcom	Case=Dat|Numb=Sing
reique	respublica	NOMcom	Case=Dat|Numb=Sing
{reique}	que	CON	MORPH=empty
vivendum	uiuo	VER	Case=Nom|Numb=Sing|Gend=Neut|Mood=Adj|Voice=Pass
est	sum1	VER	Numb=Sing|Mood=Ind|Tense=Pres|Voice=Act|Person=3
Erat	sum1	VER	Numb=Sing|Mood=Ind|Tense=Impa|Voice=Act|Person=3
olim	olim	ADV	Deg=Pos
ista	iste	PROdem	Case=Nom|Numb=Sing|Gend=Fem
sententia	sententia	NOMcom	Case=Nom|Numb=Sing
Nemo	nemo	PROind	Case=Nom|Numb=Sing
alii	alius	PROind	Case=Dat|Numb=Sing|Gend=Com
nascitur	nascor	VER	Numb=Sing|Mood=Ind|Tense=Pres|Voice=Dep|Person=3
moriturus	morior	VER	Case=Nom|Numb=Sing|Gend=Masc|Mood=Par|Tense=Fut|Voice=Dep
sibi	sui1	PROref	Case=Dat|Numb=Sing
Certe	certe	ADV	Deg=Pos
cum	cum3	CONsub	MORPH=empty
ad	ad2	PRE	MORPH=empty
Epicuros	Epicurus	NOMpro	Case=Acc|Numb=Plur
et	et2	CONcoo	MORPH=empty
Zenonas	Zenon	NOMpro	Case=Acc|Numb=Plur
ventum	uenio	VER	Case=Nom|Numb=Sing|Gend=Neut|Mood=Par|Tense=Perf|Voice=Pass
est	sum1	VER	Numb=Sing|Mood=Ind|Tense=Pres|Voice=Act|Person=3
sapientes	sapiens1	NOMcom	Case=Acc|Numb=Plur
vocas	uoco	VER	Numb=Sing|Mood=Ind|Tense=Pres|Voice=Act|Person=2
totum	totus	PROind	Case=Acc|Numb=Sing|Gend=MascNeut
quietis	quies	NOMcom	Case=Gen|Numb=Sing
magisterium	magisterium	NOMcom	Case=Acc|Numb=Sing
qui	qui1	PROrel	Case=Nom|Numb=Plur|Gend=Masc
eam	is	PROdem	Case=Acc|Numb=Sing|Gend=Fem
summae	summa	ADJqua	Case=Gen|Numb=Sing|Gend=Fem|Deg=Sup
atque	atque1	CONcoo	MORPH=empty
unicae	unicus	ADJqua	Case=Gen|Numb=Sing|Gend=Fem|Deg=Pos
voluptatis	uoluptas	NOMcom	Case=Gen|Numb=Sing
nomine	nomen	NOMcom	Case=Abl|Numb=Sing
consecravere	consecro	VER	Numb=Plur|Mood=Ind|Tense=Perf|Voice=Act|Person=3
Tamen	tamen	ADV	Deg=Pos
propemodum	propemodum	ADV	Deg=Pos
mihi	ego	PROper	Case=Dat|Numb=Sing
quoque	quoque	ADV	Deg=Pos
licebit	licet1	VER	Numb=Sing|Mood=Ind|Tense=Fut|Voice=Act|Person=3
in	in	PRE	MORPH=empty
publicum	publicum	NOMcom	Case=Acc|Numb=Sing
prodesse	prosum1	VER	Mood=Inf|Tense=Pres|Voice=Act
Soleo	soleo	VER	Numb=Sing|Mood=Ind|Tense=Pres|Voice=SemDep|Person=1
de	de	PRE	MORPH=empty
qualibet	quilibet	PROind	Case=Abl|Numb=Sing|Gend=Fem
margine	margo	NOMcom	Case=Abl|Numb=Sing
vel	uel2	CONcoo	MORPH=empty
ara	ara	NOMcom	Case=Abl|Numb=Sing
medicinas	medicina	NOMcom	Case=Acc|Numb=Plur
moribus	mos	NOMcom	Case=Dat|Numb=Plur
dicere	dico2	VER	Mood=Inf|Tense=Pres|Voice=Act
quae	qui1	PROrel	Case=Nom|Numb=Plur|Gend=Neut
felicius	feliciter	ADV	Deg=Comp
publicis	publicus2	ADJqua	Case=Dat|Numb=Plur|Gend=Com|Deg=Pos
rebus	res	NOMcom	Case=Dat|Numb=Plur
et	et2	CONcoo	MORPH=empty
civitatibus	ciuitas	NOMcom	Case=Dat|Numb=Plur
et	et2	CONcoo	MORPH=empty
imperiis	imperium	NOMcom	Case=Dat|Numb=Plur
bonas	bonus	ADJqua	Case=Acc|Numb=Plur|Gend=Fem|Deg=Pos
valetudines	ualetudo	NOMcom	Case=Acc|Numb=Plur
conferent	confero	VER	Numb=Plur|Mood=Ind|Tense=Fut|Voice=Act|Person=3
quam	quam1	ADVrel	Gend=Fem
tuse	tu	NOMcom	Case=Nom|Numb=Sing
{tuse}	sum1	VER	Numb=Sing|Mood=Ind|Tense=Pres|Voice=Act|Person=3
operae	opera	NOMcom	Case=Gen|Numb=Sing
Quippe	quippe2	CONcoo	MORPH=empty
si	si2	CONsub	MORPH=empty
pergam	pergo	VER	Numb=Sing|Mood=Sub|Tense=Pres|Voice=Act|Person=1
ad	ad2	PRE	MORPH=empty
acuta	acutus	ADJqua	Case=Acc|Numb=Plur|Gend=Neut|Deg=Pos
tecum	tu	PROper	Case=Abl|Numb=Sing
{tecum}	cum3	CON	MORPH=empty
plus	multum2	ADJqua	Deg=Comp
togae	toga	NOMcom	Case=Nom|Numb=Sing
laesere	laedo	VER	Numb=Plur|Mood=Ind|Tense=Perf|Voice=Act|Person=3
rempublicam	respublica	NOMcom	Case=Acc|Numb=Sing
quam	quam1	ADVrel	MORPH=empty
loricae	lorica	NOMcom	Case=Gen|Numb=Sing
Atquin	atqui	CONcoo	MORPH=empty
nullis	nullus	PROind	Case=Abl|Numb=Plur|Gend=Com
vitiis	uitium	NOMcom	Case=Abl|Numb=Plur
addor	addor	NOMcom	Numb=Sing|Mood=Ind|Tense=Pres|Voice=Pass|Person=1
nullis	nullus	PROind	Case=Abl|Numb=Plur|Gend=Com
veternis	ueternus1	NOMcom	Case=Gen|Numb=Plur
parco	parco	NOMcom	Case=Abl|Numb=Sing|Gend=MascNeut
nulli	nullus	PROind	Case=Dat|Numb=Sing|Gend=Com
impetigini	impetigo	NOMcom	Case=Gen|Numb=Sing
Adigo	adigo	VER	Numb=Sing|Mood=Ind|Tense=Pres|Voice=Act|Person=1
cauterem	cauter	VER	Numb=Sing
ambitioni	ambitio	NOMcom	Case=Dat|Numb=Sing
qua	qui1	PROrel	Case=Abl|Numb=Sing|Gend=Fem
M	1000	ADJcar	MORPH=empty
Tullius	Tullius	NOMpro	Case=Nom|Numb=Sing
quingentis	quingenti	ADJcar	Case=Abl|Numb=Plur|Gend=Com
milibus	mille	ADJcar	Case=Abl|Numb=Plur|Gend=Com
numum	numus	NOMcom	Case=Acc|Numb=Sing
orbem	orbis	NOMcom	Case=Acc|Numb=Sing
citri	citro	NOMcom	Case=Gen|Numb=Sing
emit	emo	VER	Numb=Sing|Mood=Ind|Tense=Perf|Voice=Act|Person=3
qua	qui1	PROrel	Case=Abl|Numb=Sing
bis	bis	ADJadv.mul	MORPH=empty
tantum	tantum1	PROdem	Numb=Sing|Deg=Pos
Asinius	Asinius	NOMpro	Case=Nom|Numb=Sing
Gallus	Gallus	NOMpro	Case=Nom|Numb=Sing
pro	pro1	PRE	MORPH=empty
mensa	mensa	NOMcom	Case=Abl|Numb=Sing
eiusdem	idem	PROdem	Case=Gen|Numb=Sing|Gend=Com
Mauritaniae	Mauritania	NOMpro	Case=Gen|Numb=Sing
numeral	numeral	NOMcom	Case=Nom|Numb=Sing
Hem	hem	INJ	MORPH=empty
quantis	quantus1	PROrel	Case=Abl|Numb=Plur|Gend=Com
facultatibus	facultas	NOMcom	Case=Abl|Numb=Plur
aestimavere	aestimo	VER	Numb=Plur|Mood=Ind|Tense=Perf|Voice=Act|Person=3
ligneas	ligneus	ADJqua	Case=Acc|Numb=Plur|Gend=Fem|Deg=Pos
maculas	macula	NOMcom	Case=Acc|Numb=Plur
item	item	ADV	Deg=Pos
qua	qua1	ADVrel	Numb=Sing|Gend=Fem
lances	lanx	NOMcom	Case=Nom|Numb=Plur
centenarii	centenarius	ADJqua	Case=Gen|Numb=Sing|Gend=MascNeut|Deg=Pos
ponderis	pondus	NOMcom	Case=Gen|Numb=Sing
Sulla	Sylla	NOMpro	Case=Nom|Numb=Sing
molitur	molior	VER	Numb=Sing|Mood=Ind|Tense=Pres|Voice=Dep|Person=3
Vereor	uereor	VER	Numb=Sing|Mood=Ind|Tense=Pres|Voice=Dep|Person=1
sane	sane	ADV	Deg=Pos
ne	ne4	CONsub	MORPH=empty
parva	paruus2	ADJqua	Case=Nom|Numb=Sing|Gend=Fem|Deg=Pos
sit	sum1	VER	Numb=Sing|Mood=Sub|Tense=Pres|Voice=Act|Person=3
ista	iste	PROdem	Case=Nom|Numb=Sing|Gend=Fem
trutina	trutina	NOMcom	Case=Abl|Numb=Sing
cum	cum3	CONsub	MORPH=empty
Drusillanus	Drusillanus	NOMpro	Case=Nom|Numb=Sing
equidem	equidem	ADV	Deg=Pos
servus	seruus1	NOMcom	Case=Nom|Numb=Sing
Claudii	Claudius	NOMpro	Case=Gen|Numb=Sing
quingenariam	quingenarius	NOMcom	Case=Acc|Numb=Sing|Gend=Fem|Deg=Pos
promulsidem	promulsis	ADJqua	Case=Acc|Numb=Sing
aedificat	aedifico	VER	Numb=Sing|Mood=Ind|Tense=Pres|Voice=Act|Person=3
suprascriptis	suprascribo	VER	Case=Abl|Numb=Plur|Gend=Com|Mood=Par|Tense=Perf|Voice=Pass
fortassean	fortasse	ADJqua	Case=Acc|Numb=Sing|Deg=Pos
mensis	mensis	NOMcom	Case=Abl|Numb=Plur
neccessariam	neccessarius	ADJqua	Case=Acc|Numb=Sing|Gend=Fem|Deg=Pos
cui	qui1	PROrel	Case=Dat|Numb=Sing|Gend=Com
si	si2	CONsub	MORPH=empty
officina	officina	NOMcom	Case=Nom|Numb=Sing
exstructa	exstruo	VER	Case=Nom|Numb=Sing|Gend=Fem|Mood=Par|Tense=Perf|Voice=Pass
est	sum1	VER	Numb=Sing|Mood=Ind|Tense=Pres|Voice=Act|Person=3
debuit	debeo	VER	Numb=Sing|Mood=Ind|Tense=Perf|Voice=Act|Person=3
et	et2	CONcoo	MORPH=empty
triclinium	triclinium	NOMcom	Case=Nom|Numb=Sing
Inmergo	immergo	ADJqua	Case=Dat|Numb=Sing|Deg=Pos
aeque	aeque	ADV	Deg=Pos
scalpellum	scalpellum	NOMcom	Case=Nom|Numb=Sing
acerbitati	acerbitas	NOMcom	Case=Dat|Numb=Sing
ei	is	PROdem	Case=Dat|Numb=Sing|Gend=Com
qua	qui1	PROrel	Case=Abl|Numb=Sing|Gend=Fem
Vedius	Uedius	ADJqua	Case=Nom|Numb=Sing
Pollio	Pollio	NOMpro	Case=Nom|Numb=Sing
servos	seruus1	NOMcom	Case=Acc|Numb=Plur
muraenis	muraena	NOMcom	Case=Dat|Numb=Plur
invadendos	inuado2	VER	Case=Acc|Numb=Plur|Gend=Masc|Mood=Adj|Voice=Pass
obiectabat	obiecto	VER	Numb=Sing|Mood=Ind|Tense=Impa|Voice=Act|Person=3
Nova	nouus	ADJqua	Case=Abl|Numb=Sing|Gend=Fem|Deg=Pos
scilicet	scilicet	ADV	Deg=Pos
saevitia	saeuitia	NOMcom	Case=Abl|Numb=Sing
delectato	delecto	VER	Case=Abl|Numb=Sing|Gend=MascNeut|Mood=Par|Tense=Perf|Voice=Pass
terrenae	terrenus	ADJqua	Case=Gen|Numb=Plur|Gend=Fem|Deg=Pos
bestiae	bestia	NOMcom	Case=Gen|Numb=Sing
et	et2	CONcoo	MORPH=empty
edentulae	edentulus	NOMcom	Case=Gen|Numb=Sing
et	et2	CONcoo	MORPH=empty
exungues	exungo	ADJqua	Case=Nom|Numb=Plur|Gend=MascFem|Deg=Pos
et	et2	CONcoo	MORPH=empty
excornes	excorno	VER	Case=Nom|Numb=Sing|Gend=MascFem|Deg=Pos
de	de	PRE	MORPH=empty
piscibus	piscis	NOMcom	Case=Abl|Numb=Plur
placuit	placeo	VER	Numb=Sing|Mood=Ind|Tense=Perf|Voice=Act|Person=3
feras	fera	NOMcom	Case=Acc|Numb=Plur
cogere	cogo	VER	Mood=Inf|Tense=Pres|Voice=Act
utique	utique	ADV	Deg=Pos
statim	statim	ADV	Deg=Pos
coquendis	coquo	VER	Case=Abl|Numb=Plur|Gend=Com|Mood=Adj|Voice=Pass
ut	ut4	CONsub	MORPH=empty
in	in	PRE	MORPH=empty
visceribus	uiscus2	NOMcom	Case=Abl|Numb=Plur
earum	is	PROdem	Case=Gen|Numb=Plur|Gend=Fem
aliquid	aliquis	PROind	Case=Acc|Numb=Sing|Gend=Neut
de	de	PRE	MORPH=empty
servorum	seruus1	NOMcom	Case=Gen|Numb=Plur
suorum	suus	PROpos.ref	Case=Gen|Numb=Plur|Gend=MascNeut
corporibus	corpus	NOMcom	Case=Abl|Numb=Plur
et	et2	CONcoo	MORPH=empty
ipse	ipse	PROdem	Case=Nom|Numb=Sing|Gend=Masc
gustaret	gusto	VER	Numb=Sing|Mood=Sub|Tense=Impa|Voice=Act|Person=3
Praecidam	praecido2	VER	Case=Acc|Numb=Sing|Gend=Fem|Person=1
gulam	gula	NOMcom	Case=Acc|Numb=Sing
qua	qui1	PROrel	Case=Abl|Numb=Sing|Gend=Fem
Hortensius	Hortensius	NOMpro	Case=Nom|Numb=Sing
orator	orator	NOMcom	Case=Nom|Numb=Sing
primus	primus	ADJord	Case=Nom|Numb=Sing|Gend=Masc|Deg=Sup
pavum	pauus	NOMcom	Case=Acc|Numb=Sing|Deg=Pos
cibi	cibus	NOMcom	Case=Gen|Numb=Sing
causa	causa	NOMcom	Case=Abl|Numb=Sing
potuit	possum1	VER	Numb=Sing|Mood=Ind|Tense=Perf|Voice=Act|Person=3
occidere	occido2	VER	Mood=Inf|Tense=Pres|Voice=Act
qua	qui1	PROrel	Case=Abl
Aufidius	Aufidius	NOMpro	Case=Nom|Numb=Sing
Lurco	Lurco	NOMpro	Case=Nom|Numb=Sing
primus	primus	ADJord	Case=Nom|Numb=Sing|Gend=Masc|Deg=Sup
sagina	sagina	NOMcom	Case=Abl|Numb=Sing
corpora	corpus	NOMcom	Case=Acc|Numb=Plur
vitiavit	uitio1	VER	Numb=Sing|Mood=Ind|Tense=Perf|Voice=Act|Person=3
et	et2	CONcoo	MORPH=empty
coactis	cogo	VER	Case=Abl|Numb=Plur|Gend=Com|Mood=Par|Tense=Perf|Voice=Pass
alimentis	alimentum	NOMcom	Case=Abl|Numb=Plur
in	in	PRE	MORPH=empty
adulterinum	adulterinus	NOMcom	Case=Acc|Numb=Sing|Gend=MascNeut|Deg=Pos
provexit	proueho	VER	Numb=Sing|Mood=Ind|Tense=Perf|Voice=Act|Person=3
saporem	sapor	NOMcom	Case=Acc|Numb=Sing
qua	qui1	PROrel	Case=Abl
Asinius	Asinius	NOMpro	Case=Nom|Numb=Sing
Celer	Celer	NOMpro	Case=Nom|Numb=Sing
mulli	mullus	NOMcom	Case=Gen|Numb=Sing
unius	unus	ADJcar	Case=Gen|Numb=Sing|Gend=Com
obsonium	obsonium	NOMcom	Case=Acc|Numb=Sing
sex	sex	ADJcar	Case=Ind
sestertiis	sestertium	NOMcom	Case=Abl|Numb=Plur
detulit	defero	VER	Numb=Sing|Mood=Ind|Tense=Perf|Voice=Act|Person=3
qua	qui1	PROrel	Case=Abl
Aesopus	Aesopus	NOMpro	Case=Nom|Numb=Sing
histrio	histrio	NOMcom	Case=Nom|Numb=Sing
ex	ex	PRE	MORPH=empty
avibus	auis	NOMcom	Case=Abl|Numb=Plur
eiusdem	idem	PROdem	Case=Gen|Numb=Sing|Gend=Com
pretiositatis	pretiositas	NOMcom	Case=Gen|Numb=Sing
ut	ut1	ADVrel	MORPH=empty
canoris	canorus	ADJqua	Case=Abl|Numb=Plur|Gend=Com|Deg=Pos
et	et2	CONcoo	MORPH=empty
loquacibus	loquax	ADJqua	Case=Abl|Numb=Plur|Gend=Com|Deg=Pos
quibusque	qui	PROrel	Case=Dat|Numb=Plur|Gend=Com
{quibusque}	que	CON	MORPH=empty
centum	centum	ADJcar	Case=Ind
milium	mille	ADJcar	Case=Gen|Numb=Plur|Gend=Com
patinam	patina	NOMcom	Case=Acc|Numb=Sing
confiscavit	confisco	VER	Numb=Sing|Mood=Ind|Tense=Perf|Voice=Act|Person=3
qua	qui1	PROrel	Case=Abl
filius	filius	NOMcom	Case=Nom|Numb=Sing
eius	is	PROdem	Case=Gen|Numb=Sing|Gend=Com
post	post2	PRE	MORPH=empty
tale	talis	PROdem	Case=Acc|Numb=Sing|Gend=Neut
pulpamentum	pulpamentum	NOMcom	Case=Acc|Numb=Sing
potuit	possum1	VER	Numb=Sing|Mood=Ind|Tense=Perf|Voice=Act|Person=3
aliquid	aliquis	PROind	Case=Acc|Numb=Sing|Gend=Neut
sumptuosius	sumptuose	ADJqua	Case=Acc|Gend=Neut|Deg=Comp
esurire	esurio2	VER	Mood=Inf|Tense=Pres|Voice=Act
Margarita	Margarita	NOMcom	Case=Acc|Numb=Sing
namque	namque	CONcoo	MORPH=empty
vel	uel2	CONcoo	Deg=Pos
ipso	ipse	PROdem	Case=Abl|Numb=Sing|Gend=MascNeut
nomine	nomen	NOMcom	Case=Abl|Numb=Sing
pretiosa	pretiosus	ADJqua	Case=Acc|Numb=Plur|Gend=Neut|Deg=Pos
dehausit	dehaurio	VER	Numb=Sing|Mood=Ind|Tense=Perf|Voice=Act|Person=3
credo	credo	VER	Numb=Sing|Mood=Ind|Tense=Pres|Voice=Act|Person=1
ne	ne4	CONsub	MORPH=empty
mendicius	mendicius	ADJqua	Numb=Sing|Deg=Comp
patre	pater	NOMcom	Case=Abl|Numb=Sing
coenasset	coeno	VER	Numb=Sing|Mood=Sub|Tense=Pqp|Voice=Act|Person=3
Taceo	taceo	VER	Numb=Sing|Mood=Ind|Tense=Pres|Voice=Act|Person=1
Nerones	Nero	NOMpro	Case=Acc|Numb=Plur
et	et2	CONcoo	MORPH=empty
Apicios	Apicii	NOMpro	Case=Acc|Numb=Plur
et	et2	CONcoo	MORPH=empty
Rufos	Rufus	NOMpro	Case=Acc|Numb=Plur
Dabo	do	VER	Numb=Sing|Mood=Ind|Tense=Fut|Voice=Act|Person=1
catharticum	catharticus	NOMcom	Case=Acc|Numb=Sing
impuritati	impuritas	NOMcom	Case=Dat|Numb=Sing
Scauri	Scaurus	NOMpro	Case=Gen|Numb=Sing
et	et2	CONcoo	MORPH=empty
aleae	alea	NOMcom	Case=Gen|Numb=Sing
Curii	Curius	NOMpro	Case=Gen|Numb=Sing
et	et2	CONcoo	MORPH=empty
vinolentiae	uinolentia	NOMcom	Case=Dat|Numb=Sing
Antonii	Antonius	NOMpro	Case=Gen|Numb=Sing
Et	et2	CONcoo	MORPH=empty
memento	memini	VER	Numb=Sing|Mood=Imp|Tense=Fut|Voice=Act|Person=2
istos	iste	PROdem	Case=Acc|Numb=Plur|Gend=Masc
interim	interim	ADV	Deg=Pos
ex	ex	PRE	MORPH=empty
multis	multi	ADJqua	Case=Abl|Numb=Plur|Gend=Com|Deg=Pos
togatos	togatus	ADJqua	Case=Acc|Numb=Plur|Gend=Masc|Deg=Pos
fuisse	sum1	VER	Mood=Inf|Tense=Perf|Voice=Act
quales	qualis1	PROrel	Case=Acc|Numb=Plur|Gend=MascFem
apud	apud	PRE	MORPH=empty
pallium	pallium	NOMcom	Case=Acc|Numb=Sing
haud	haud	ADVneg	MORPH=empty
facile	facile	ADV	Deg=Pos
Has	hic1	PROdem	Case=Acc|Numb=Plur|Gend=Fem
purulentias	purulentia	NOMcom	Case=Acc|Numb=Plur
civitatis	ciuitas	NOMcom	Case=Gen|Numb=Sing
quis	quis1	PROrel	Case=Nom|Numb=Sing|Gend=MascFem
eliciet	elicio	VER	Numb=Sing|Mood=Ind|Tense=Fut|Voice=Act|Person=3
et	et2	CONcoo	MORPH=empty
exsuppurabit	exsuppuro	VER	Numb=Sing|Mood=Ind|Tense=Fut|Voice=Act|Person=3
ni	ni2	CONsub	MORPH=empty
sermo	sermo	NOMcom	Case=Nom|Numb=Sing
palliatus	palliatus	ADJqua	Case=Nom|Numb=Sing|Gend=Masc|Deg=Pos
Sermone	sermo	NOMcom	Case=Abl|Numb=Sing
inquit	inquio	VER	Numb=Sing|Mood=Ind|Tense=Pres|Voice=Act|Person=3
me	ego	PROper	Case=Acc|Numb=Sing
suasisti	suadeo	VER	Numb=Sing|Mood=Ind|Tense=Perf|Voice=Act|Person=2
medicamine	medicamen	NOMcom	Case=Abl|Numb=Sing
sapientissimo	sapiens2	ADJqua	Case=Abl|Numb=Sing|Gend=MascNeut|Deg=Sup
Verum	uerum4	CONcoo	Numb=Sing
etsi	etsi2	CONsub	MORPH=empty
eloquium	eloquium	NOMcom	Case=Nom|Numb=Sing
quiescat	quiesco	VER	Numb=Sing|Mood=Sub|Tense=Pres|Voice=Act|Person=3
aut	aut	CONcoo	MORPH=empty
infantia	infantia	NOMcom	Case=Abl|Numb=Sing
subductum	subduco	VER	Case=Nom|Numb=Sing|Gend=MascNeut|Mood=Par|Tense=Perf|Voice=Pass
aut	aut	CONcoo	MORPH=empty
verecundia	uerecundia	NOMcom	Case=Abl|Numb=Sing
retentum	retineo	VER	Case=Nom|Numb=Sing|Gend=MascNeut|Mood=Par|Tense=Perf|Voice=Pass
nam	nam	CONcoo	MORPH=empty
et	et2	CONcoo	MORPH=empty
elingua	elinguus	NOMcom	Case=Abl|Numb=Sing|Deg=Pos
philosophia	philosophia	NOMcom	Case=Nom|Numb=Sing
vita	uita	NOMcom	Case=Nom|Numb=Sing
contenta	contentus1	ADJqua	Case=Nom|Numb=Sing|Gend=Fem|Deg=Pos
est	sum1	VER	Numb=Sing|Mood=Ind|Tense=Pres|Voice=Act|Person=3
ipse	ipse	PROdem	Case=Nom|Numb=Sing|Gend=Masc
habitus	habitus1	NOMcom	Case=Nom|Numb=Sing
sonat	sono1	VER	Numb=Sing|Mood=Ind|Tense=Pres|Voice=Act|Person=3
Sic	sic	ADV	Deg=Pos
denique	denique	ADV	Deg=Pos
auditur	audio	VER	Numb=Sing|Mood=Ind|Tense=Pres|Voice=Pass|Person=3
philosophus	philosophus1	NOMcom	Case=Nom|Numb=Sing
dum	dum2	CONsub	MORPH=empty
videntur	uideo	VER	Numb=Plur|Mood=Ind|Tense=Pres|Voice=Pass|Person=3
De	de	PRE	MORPH=empty
occursu	occursus	NOMcom	Case=Abl|Numb=Sing
meo	meus	PROpos	Case=Abl|Numb=Sing|Gend=MascNeut
vitia	uitium	NOMcom	Case=Nom|Numb=Plur
suffundo	suffundo2	VER	Numb=Sing|Mood=Ind|Tense=Pres|Voice=Act|Person=1
Quis	quis1	PROint	Case=Nom|Numb=Sing|Gend=MascFem
non	non	ADVneg	MORPH=empty
aemulum	aemulus1	NOMcom	Case=Acc|Numb=Sing
suum	suus	PROpos.ref	Case=Acc|Numb=Sing|Gend=MascNeut
cum	cum3	CONsub	MORPH=empty
videt	uideo	VER	Numb=Sing|Mood=Ind|Tense=Pres|Voice=Act|Person=3
patitur	patior	VER	Numb=Sing|Mood=Ind|Tense=Pres|Voice=Dep|Person=3
quis	quis1	PROint	Case=Nom|Numb=Sing|Gend=MascFem
oculis	oculus	NOMcom	Case=Abl|Numb=Plur
in	in	PRE	MORPH=empty
eum	is	PROdem	Case=Acc|Numb=Sing|Gend=Masc
potest	possum1	VER	Numb=Sing|Mood=Ind|Tense=Pres|Voice=Act|Person=3
in	in	PRE	MORPH=empty
quem	qui1	PROrel	Case=Acc|Numb=Sing|Gend=Masc
mentibus	mens	NOMcom	Case=Abl|Numb=Plur
non	non	ADVneg	MORPH=empty
potest	possum1	VER	Numb=Sing|Mood=Ind|Tense=Pres|Voice=Act|Person=3
Grande	grandis	ADJqua	Case=Nom|Numb=Sing|Gend=Neut|Deg=Pos
pallii	pallium	NOMcom	Case=Gen|Numb=Sing
beneficium	beneficium	NOMcom	Case=Nom|Numb=Sing
est	sum1	VER	Numb=Sing|Mood=Ind|Tense=Pres|Voice=Act|Person=3
sub	sub	PRE	MORPH=empty
cuius	qui1	PROrel	Case=Gen|Numb=Sing|Gend=Com
recogitatu	recogitatus	NOMcom	Case=Abl|Numb=Sing
improbi	improbus	ADJqua	Case=Nom|Numb=Plur|Gend=Masc|Deg=Pos
mores	mos	NOMcom	Case=Nom|Numb=Plur
vel	uel2	CONcoo	Deg=Pos
erubescunt	erubesco	VER	Numb=Plur|Mood=Ind|Tense=Pres|Voice=Act|Person=3
Viderit	uideo	VER	Numb=Sing|Mood=Sub|Tense=Perf|Voice=Act|Person=3
nunc	nunc	ADV	Deg=Pos
philosophia	philosophia	NOMcom	Case=Nom|Numb=Sing
quid	quis1	PROint	Case=Acc|Numb=Sing|Gend=Neut
prosit	prosum1	VER	Numb=Sing|Mood=Sub|Tense=Pres|Voice=Act|Person=3
nec	nec2	CONcoo	MORPH=empty
enim	enim2	CONcoo	MORPH=empty
sola	solus	PROind	Case=Nom|Numb=Sing|Gend=Fem
mecum	ego	PROper	Case=Abl|Numb=Sing
{mecum}	cum3	CON	MORPH=empty
est	sum1	VER	Numb=Sing|Mood=Ind|Tense=Pres|Voice=Act|Person=3
Habeo	habeo	VER	Numb=Sing|Mood=Ind|Tense=Pres|Voice=Act|Person=1
et	et2	CONcoo	MORPH=empty
alias	alias	PROind	Case=Acc|Numb=Plur|Gend=Fem
artes	ars	NOMcom	Case=Acc|Numb=Plur
in	in	PRE	MORPH=empty
publico	publicum	NOMcom	Case=Dat|Numb=Sing|Deg=Pos
utiles	utilis	ADJqua	Case=Nom|Numb=Plur|Gend=MascFem|Deg=Pos
De	de	PRE	MORPH=empty
meo	meus	PROpos	Case=Abl|Numb=Sing
vestiuntur	uestio	VER	Numb=Plur|Mood=Ind|Tense=Pres|Voice=Pass|Person=3
et	et2	CONcoo	MORPH=empty
primus	primus	ADJord	Case=Nom|Numb=Sing|Gend=Masc|Deg=Sup
informator	informator	NOMcom	Case=Nom|Numb=Sing
litterarum	littera	NOMcom	Case=Gen|Numb=Plur
et	et2	CONcoo	MORPH=empty
primus	primus	ADJord	Case=Nom|Numb=Sing|Gend=Masc|Deg=Sup
enodator	enodator	NOMcom	Case=Nom|Numb=Sing
vocis	uox	NOMcom	Case=Gen|Numb=Sing
et	et2	CONcoo	MORPH=empty
primus	primus	ADJord	Case=Nom|Numb=Sing|Gend=Masc|Deg=Sup
numerorum	numerus	NOMcom	Case=Gen|Numb=Plur
harenarius	harenarius	NOMcom	Case=Nom|Numb=Sing
et	et2	CONcoo	MORPH=empty
grammaticus	grammaticus1	NOMcom	Case=Nom|Numb=Sing
et	et2	CONcoo	MORPH=empty
rhetor	rhetor	NOMcom	Case=Nom|Numb=Sing
et	et2	CONcoo	MORPH=empty
sophista	sophistes	NOMcom	Case=Nom|Numb=Sing
et	et2	CONcoo	MORPH=empty
medicus	medicus1	NOMcom	Case=Nom|Numb=Sing
et	et2	CONcoo	MORPH=empty
poeta	poeta	NOMcom	Case=Nom|Numb=Sing
et	et2	CONcoo	MORPH=empty
qui	qui1	PROrel	Case=Nom|Numb=Sing|Gend=Masc
musicam	musica2	NOMcom	Case=Acc|Numb=Sing
pulsat	pulso	VER	Numb=Sing|Mood=Ind|Tense=Pres|Voice=Act|Person=3
et	et2	CONcoo	MORPH=empty
qui	qui1	PROrel	Case=Nom|Numb=Sing|Gend=Masc
stellarem	stellaris	VER	Case=Acc|Numb=Sing|Mood=Sub|Tense=Impa|Voice=Act
coniectat	coniecto	VER	Numb=Sing|Mood=Ind|Tense=Pres|Voice=Act|Person=3
et	et2	CONcoo	MORPH=empty
qui	qui1	PROrel	Case=Nom|Numb=Sing|Gend=Masc
volaticam	uolaticus	ADJqua	Case=Acc|Numb=Sing|Deg=Pos
spectat	specto	VER	Numb=Sing|Mood=Ind|Tense=Pres|Voice=Act|Person=3
Omnis	omnis	PROind	Case=Nom|Numb=Sing|Gend=MascFem
liberalitas	liberalitas	NOMcom	Case=Nom|Numb=Sing
studiorum	studium	NOMcom	Case=Gen|Numb=Plur
quatuor	quatuor	ADJcar	MORPH=empty
meis	meus	PROpos	Case=Abl|Numb=Plur|Gend=Com
angulis	angulus	NOMcom	Case=Dat|Numb=Plur
tegitur	tego	VER	Numb=Sing|Mood=Ind|Tense=Pres|Voice=Pass|Person=3
Plane	plane	ADV	Deg=Pos
post	post2	PRE	MORPH=empty
Romanos	Romanus	ADJqua	Case=Acc|Numb=Plur|Gend=Masc|Deg=Pos
equites	eques	NOMcom	Case=Acc|Numb=Plur
Verum	uerum4	CONcoo	MORPH=empty
et	et2	CONcoo	MORPH=empty
accendones	accendo	NOMcom	Case=Acc|Numb=Plur
et	et2	CONcoo	MORPH=empty
omnis	omnis	PROind	Case=Nom|Numb=Sing|Gend=MascFem
gladiatorum	gladiator	NOMcom	Case=Gen|Numb=Plur
ignominia	ignominia	NOMcom	Case=Nom|Numb=Sing
togata	togatus	ADJqua	Case=Nom|Numb=Sing|Gend=Fem|Deg=Pos
producitur	produco	VER	Numb=Sing|Mood=Ind|Tense=Pres|Voice=Pass|Person=3
Haec	hic1	PROdem	Case=Nom|Numb=Sing|Gend=Fem
nimirum	nimirum	ADV	Deg=Pos
indignitas	indignitas	NOMcom	Case=Nom|Numb=Sing
erit	sum1	VER	Numb=Sing|Mood=Ind|Tense=Fut|Voice=Act|Person=3
A	ab	PRE	MORPH=empty
toga	toga	NOMcom	Case=Abl|Numb=Sing
ad	ad2	PRE	MORPH=empty
pallium	pallium	NOMcom	Case=Acc|Numb=Sing
Sed	sed	CONcoo	MORPH=empty
ista	iste	PROdem	Case=Acc|Numb=Sing|Gend=Fem
pallium	pallium	NOMcom	Case=Acc|Numb=Sing
loquitur	loquor	VER	Numb=Sing|Mood=Ind|Tense=Pres|Voice=Dep|Person=3
At	at2	CONcoo	MORPH=empty
ego	ego	PROper	Case=Nom|Numb=Sing
iam	iam	ADV	Deg=Pos
illi	ille	PROdem	Case=Dat|Numb=Sing|Gend=Com
etiam	etiam	ADV	Deg=Pos
divinae	diuinus2	ADJqua	Case=Gen|Numb=Sing|Gend=Fem|Deg=Pos
sectae	secta	NOMcom	Case=Gen|Numb=Sing
ac	ac1	CONcoo	MORPH=empty
disciplinae	disciplina	NOMcom	Case=Gen|Numb=Sing
commercium	commercium	NOMcom	Case=Acc|Numb=Sing
confero	confero	VER	Numb=Sing|Mood=Ind|Tense=Pres|Voice=Act|Person=1
Gaude	gaudeo	VER	Numb=Sing|Mood=Imp|Tense=Pres|Voice=SemDep|Person=2
pallium	pallium	NOMcom	Case=Acc|Numb=Sing
et	et2	CONcoo	MORPH=empty
exsulta	exsulto	VER	Numb=Sing|Mood=Imp|Tense=Pres|Voice=Act
Melior	bonus	ADJqua	Case=Nom|Numb=Sing|Gend=MascFem|Deg=Comp
iam	iam	ADV	Deg=Pos
te	tu	PROper	Case=Acc|Numb=Sing
philosophia	philosophia	NOMcom	Case=Nom|Numb=Sing
dignata	dignor	ADJqua	Case=Nom|Numb=Sing|Gend=Fem|Mood=Par|Tense=Perf|Voice=Dep
est	sum1	VER	Numb=Sing|Mood=Ind|Tense=Pres|Voice=Act|Person=3
ex	ex	PRE	MORPH=empty
quo	qui1	PROrel	Case=Abl|Numb=Sing|Gend=MascNeut
Christianum	Christianus	NOMpro	Case=Acc|Numb=Sing
vestire	uestio	VER	Mood=Inf|Tense=Pres|Voice=Act
coepisti	coepio	VER	Numb=Sing|Mood=Ind|Tense=Perf|Voice=Act|Person=2
